I	एक
II	दो
III	तीन
IV	चार
V	पाँच
VI	छह
VII	सात
VIII	आठ
IX	नौ
X	दस
XI	ग्यारह
XII	बारह
XIII	तेरह
XIV	चौदह
XV	पंद्रह
XVI	सोलह
XVII	सत्रह
XVIII	अठारह
XIX	उन्नीस
XX	बीस
XXI	इक्कीस
XXII	बाईस
XXIII	तेईस
XXIV	चौबीस
XXV	पच्चीस
XXVI	छब्बीस
XXVII	सत्ताईस
XXVIII	अट्ठाईस
XXIX	उनतीस
XXX	तीस
XXXI	इकतीस
XXXII	बत्तीस
XXXIII	तैंतीस
XXXIV	चौंतीस
XXXV	पैंतीस
XXXVI	छत्तीस
XXXVII	सैंतीस
XXXVIII	अड़तीस
XXXIX	उनतालीस
XL	चालीस
XLI	इकतालीस
XLII	बयालीस
XLIII	तैंतालीस
XLIV	चौवालीस
XLV	पैंतालीस
XLVI	छियालीस
XLVII	सैंतालीस
XLVIII	अड़तालीस
XLIX	उनचास
L	पचास
LI	इक्यावन
LII	बावन
LIII	तिरेपन
LIV	चौवन
LV	पचपन
LVI	छप्पन
LVII	सत्तावन
LVIII	अट्ठावन
LIX	उनसठ
LX	साठ
LXI	इकसठ
LXII	बासठ
LXIII	तिरेसठ
LXIV	चौंसठ
LXV	पैंसठ
LXVI	छियासठ
LXVII	सड़सठ
LXVIII	अड़सठ
LXIX	उनहत्तर
LXX	सत्तर
LXXI	इकहत्तर
LXXII	बहत्तर
LXXIII	तिहत्तर
LXXIV	चौहत्तर
LXXV	पचहत्तर
LXXVI	छिहत्तर
LXXVII	सतहत्तर
LXXVIII	अठहत्तर
LXXIX	उनासी
LXXX	अस्सी
LXXXI	इक्यासी
LXXXII	बयासी
LXXXIII	तिरासी
LXXXIV	चौरासी
LXXXV	पचासी
LXXXVI	छियासी
LXXXVII	सत्तासी
LXXXVIII	अट्ठासी
LXXXIX	नवासी
XC	नब्बे
XCI	इक्यानबे
XCII	बानबे
XCIII	तिरानबे
XCIV	चौरानबे
XCV	पंचानबे
XCVI	छियानबे
XCVII	सत्तानबे
XCVIII	अट्ठानबे
XCIX	निन्यानबे
C	एक सौ
CI	एक सौ एक
CII	एक सौ दो
CIII	एक सौ तीन
CIV	एक सौ चार
CV	एक सौ पाँच
CVI	एक सौ छह
CVII	एक सौ सात
CVIII	एक सौ आठ
CIX	एक सौ नौ
CX	एक सौ दस
CXI	एक सौ ग्यारह
CXII	एक सौ बारह
CXIII	एक सौ तेरह
CXIV	एक सौ चौदह
CXV	एक सौ पंद्रह
CXVI	एक सौ सोलह
CXVII	एक सौ सत्रह
CXVIII	एक सौ अठारह
CXIX	एक सौ उन्नीस
CXX	एक सौ बीस
CXXI	एक सौ इक्कीस
CXXII	एक सौ बाईस
CXXIII	एक सौ तेईस
CXXIV	एक सौ चौबीस
CXXV	एक सौ पच्चीस
CXXVI	एक सौ छब्बीस
CXXVII	एक सौ सत्ताईस
CXXVIII	एक सौ अट्ठाईस
CXXIX	एक सौ उनतीस
CXXX	एक सौ तीस
CXXXI	एक सौ इकतीस
CXXXII	एक सौ बत्तीस
CXXXIII	एक सौ तैंतीस
CXXXIV	एक सौ चौंतीस
CXXXV	एक सौ पैंतीस
CXXXVI	एक सौ छत्तीस
CXXXVII	एक सौ सैंतीस
CXXXVIII	एक सौ अड़तीस
CXXXIX	एक सौ उनतालीस
CXL	एक सौ चालीस
CXLI	एक सौ इकतालीस
CXLII	एक सौ बयालीस
CXLIII	एक सौ तैंतालीस
CXLIV	एक सौ चौवालीस
CXLV	एक सौ पैंतालीस
CXLVI	एक सौ छियालीस
CXLVII	एक सौ सैंतालीस
CXLVIII	एक सौ अड़तालीस
CXLIX	एक सौ उनचास
CL	एक सौ पचास
CLI	एक सौ इक्यावन
CLII	एक सौ बावन
CLIII	एक सौ तिरेपन
CLIV	एक सौ चौवन
CLV	एक सौ पचपन
CLVI	एक सौ छप्पन
CLVII	एक सौ सत्तावन
CLVIII	एक सौ अट्ठावन
CLIX	एक सौ उनसठ
CLX	एक सौ साठ
CLXI	एक सौ इकसठ
CLXII	एक सौ बासठ
CLXIII	एक सौ तिरेसठ
CLXIV	एक सौ चौंसठ
CLXV	एक सौ पैंसठ
CLXVI	एक सौ छियासठ
CLXVII	एक सौ सड़सठ
CLXVIII	एक सौ अड़सठ
CLXIX	एक सौ उनहत्तर
CLXX	एक सौ सत्तर
CLXXI	एक सौ इकहत्तर
CLXXII	एक सौ बहत्तर
CLXXIII	एक सौ तिहत्तर
CLXXIV	एक सौ चौहत्तर
CLXXV	एक सौ पचहत्तर
CLXXVI	एक सौ छिहत्तर
CLXXVII	एक सौ सतहत्तर
CLXXVIII	एक सौ अठहत्तर
CLXXIX	एक सौ उनासी
CLXXX	एक सौ अस्सी
CLXXXI	एक सौ इक्यासी
CLXXXII	एक सौ बयासी
CLXXXIII	एक सौ तिरासी
CLXXXIV	एक सौ चौरासी
CLXXXV	एक सौ पचासी
CLXXXVI	एक सौ छियासी
CLXXXVII	एक सौ सत्तासी
CLXXXVIII	एक सौ अट्ठासी
CLXXXIX	एक सौ नवासी
CXC	एक सौ नब्बे
CXCI	एक सौ इक्यानबे
CXCII	एक सौ बानबे
CXCIII	एक सौ तिरानबे
CXCIV	एक सौ चौरानबे
CXCV	एक सौ पंचानबे
CXCVI	एक सौ छियानबे
CXCVII	एक सौ सत्तानबे
CXCVIII	एक सौ अट्ठानबे
CXCIX	एक सौ निन्यानबे
CC	दो सौ
CCI	दो सौ एक
CCII	दो सौ दो
CCIII	दो सौ तीन
CCIV	दो सौ चार
CCV	दो सौ पाँच
CCVI	दो सौ छह
CCVII	दो सौ सात
CCVIII	दो सौ आठ
CCIX	दो सौ नौ
CCX	दो सौ दस
CCXI	दो सौ ग्यारह
CCXII	दो सौ बारह
CCXIII	दो सौ तेरह
CCXIV	दो सौ चौदह
CCXV	दो सौ पंद्रह
CCXVI	दो सौ सोलह
CCXVII	दो सौ सत्रह
CCXVIII	दो सौ अठारह
CCXIX	दो सौ उन्नीस
CCXX	दो सौ बीस
CCXXI	दो सौ इक्कीस
CCXXII	दो सौ बाईस
CCXXIII	दो सौ तेईस
CCXXIV	दो सौ चौबीस
CCXXV	दो सौ पच्चीस
CCXXVI	दो सौ छब्बीस
CCXXVII	दो सौ सत्ताईस
CCXXVIII	दो सौ अट्ठाईस
CCXXIX	दो सौ उनतीस
CCXXX	दो सौ तीस
CCXXXI	दो सौ इकतीस
CCXXXII	दो सौ बत्तीस
CCXXXIII	दो सौ तैंतीस
CCXXXIV	दो सौ चौंतीस
CCXXXV	दो सौ पैंतीस
CCXXXVI	दो सौ छत्तीस
CCXXXVII	दो सौ सैंतीस
CCXXXVIII	दो सौ अड़तीस
CCXXXIX	दो सौ उनतालीस
CCXL	दो सौ चालीस
CCXLI	दो सौ इकतालीस
CCXLII	दो सौ बयालीस
CCXLIII	दो सौ तैंतालीस
CCXLIV	दो सौ चौवालीस
CCXLV	दो सौ पैंतालीस
CCXLVI	दो सौ छियालीस
CCXLVII	दो सौ सैंतालीस
CCXLVIII	दो सौ अड़तालीस
CCXLIX	दो सौ उनचास
CCL	दो सौ पचास
CCLI	दो सौ इक्यावन
CCLII	दो सौ बावन
CCLIII	दो सौ तिरेपन
CCLIV	दो सौ चौवन
CCLV	दो सौ पचपन
CCLVI	दो सौ छप्पन
CCLVII	दो सौ सत्तावन
CCLVIII	दो सौ अट्ठावन
CCLIX	दो सौ उनसठ
CCLX	दो सौ साठ
CCLXI	दो सौ इकसठ
CCLXII	दो सौ बासठ
CCLXIII	दो सौ तिरेसठ
CCLXIV	दो सौ चौंसठ
CCLXV	दो सौ पैंसठ
CCLXVI	दो सौ छियासठ
CCLXVII	दो सौ सड़सठ
CCLXVIII	दो सौ अड़सठ
CCLXIX	दो सौ उनहत्तर
CCLXX	दो सौ सत्तर
CCLXXI	दो सौ इकहत्तर
CCLXXII	दो सौ बहत्तर
CCLXXIII	दो सौ तिहत्तर
CCLXXIV	दो सौ चौहत्तर
CCLXXV	दो सौ पचहत्तर
CCLXXVI	दो सौ छिहत्तर
CCLXXVII	दो सौ सतहत्तर
CCLXXVIII	दो सौ अठहत्तर
CCLXXIX	दो सौ उनासी
CCLXXX	दो सौ अस्सी
CCLXXXI	दो सौ इक्यासी
CCLXXXII	दो सौ बयासी
CCLXXXIII	दो सौ तिरासी
CCLXXXIV	दो सौ चौरासी
CCLXXXV	दो सौ पचासी
CCLXXXVI	दो सौ छियासी
CCLXXXVII	दो सौ सत्तासी
CCLXXXVIII	दो सौ अट्ठासी
CCLXXXIX	दो सौ नवासी
CCXC	दो सौ नब्बे
CCXCI	दो सौ इक्यानबे
CCXCII	दो सौ बानबे
CCXCIII	दो सौ तिरानबे
CCXCIV	दो सौ चौरानबे
CCXCV	दो सौ पंचानबे
CCXCVI	दो सौ छियानबे
CCXCVII	दो सौ सत्तानबे
CCXCVIII	दो सौ अट्ठानबे
CCXCIX	दो सौ निन्यानबे
CCC	तीन सौ
CCCI	तीन सौ एक
CCCII	तीन सौ दो
CCCIII	तीन सौ तीन
CCCIV	तीन सौ चार
CCCV	तीन सौ पाँच
CCCVI	तीन सौ छह
CCCVII	तीन सौ सात
CCCVIII	तीन सौ आठ
CCCIX	तीन सौ नौ
CCCX	तीन सौ दस
CCCXI	तीन सौ ग्यारह
CCCXII	तीन सौ बारह
CCCXIII	तीन सौ तेरह
CCCXIV	तीन सौ चौदह
CCCXV	तीन सौ पंद्रह
CCCXVI	तीन सौ सोलह
CCCXVII	तीन सौ सत्रह
CCCXVIII	तीन सौ अठारह
CCCXIX	तीन सौ उन्नीस
CCCXX	तीन सौ बीस
CCCXXI	तीन सौ इक्कीस
CCCXXII	तीन सौ बाईस
CCCXXIII	तीन सौ तेईस
CCCXXIV	तीन सौ चौबीस
CCCXXV	तीन सौ पच्चीस
CCCXXVI	तीन सौ छब्बीस
CCCXXVII	तीन सौ सत्ताईस
CCCXXVIII	तीन सौ अट्ठाईस
CCCXXIX	तीन सौ उनतीस
CCCXXX	तीन सौ तीस
CCCXXXI	तीन सौ इकतीस
CCCXXXII	तीन सौ बत्तीस
CCCXXXIII	तीन सौ तैंतीस
CCCXXXIV	तीन सौ चौंतीस
CCCXXXV	तीन सौ पैंतीस
CCCXXXVI	तीन सौ छत्तीस
CCCXXXVII	तीन सौ सैंतीस
CCCXXXVIII	तीन सौ अड़तीस
CCCXXXIX	तीन सौ उनतालीस
CCCXL	तीन सौ चालीस
CCCXLI	तीन सौ इकतालीस
CCCXLII	तीन सौ बयालीस
CCCXLIII	तीन सौ तैंतालीस
CCCXLIV	तीन सौ चौवालीस
CCCXLV	तीन सौ पैंतालीस
CCCXLVI	तीन सौ छियालीस
CCCXLVII	तीन सौ सैंतालीस
CCCXLVIII	तीन सौ अड़तालीस
CCCXLIX	तीन सौ उनचास
CCCL	तीन सौ पचास
CCCLI	तीन सौ इक्यावन
CCCLII	तीन सौ बावन
CCCLIII	तीन सौ तिरेपन
CCCLIV	तीन सौ चौवन
CCCLV	तीन सौ पचपन
CCCLVI	तीन सौ छप्पन
CCCLVII	तीन सौ सत्तावन
CCCLVIII	तीन सौ अट्ठावन
CCCLIX	तीन सौ उनसठ
CCCLX	तीन सौ साठ
CCCLXI	तीन सौ इकसठ
CCCLXII	तीन सौ बासठ
CCCLXIII	तीन सौ तिरेसठ
CCCLXIV	तीन सौ चौंसठ
CCCLXV	तीन सौ पैंसठ
CCCLXVI	तीन सौ छियासठ
CCCLXVII	तीन सौ सड़सठ
CCCLXVIII	तीन सौ अड़सठ
CCCLXIX	तीन सौ उनहत्तर
CCCLXX	तीन सौ सत्तर
CCCLXXI	तीन सौ इकहत्तर
CCCLXXII	तीन सौ बहत्तर
CCCLXXIII	तीन सौ तिहत्तर
CCCLXXIV	तीन सौ चौहत्तर
CCCLXXV	तीन सौ पचहत्तर
CCCLXXVI	तीन सौ छिहत्तर
CCCLXXVII	तीन सौ सतहत्तर
CCCLXXVIII	तीन सौ अठहत्तर
CCCLXXIX	तीन सौ उनासी
CCCLXXX	तीन सौ अस्सी
CCCLXXXI	तीन सौ इक्यासी
CCCLXXXII	तीन सौ बयासी
CCCLXXXIII	तीन सौ तिरासी
CCCLXXXIV	तीन सौ चौरासी
CCCLXXXV	तीन सौ पचासी
CCCLXXXVI	तीन सौ छियासी
CCCLXXXVII	तीन सौ सत्तासी
CCCLXXXVIII	तीन सौ अट्ठासी
CCCLXXXIX	तीन सौ नवासी
CCCXC	तीन सौ नब्बे
CCCXCI	तीन सौ इक्यानबे
CCCXCII	तीन सौ बानबे
CCCXCIII	तीन सौ तिरानबे
CCCXCIV	तीन सौ चौरानबे
CCCXCV	तीन सौ पंचानबे
CCCXCVI	तीन सौ छियानबे
CCCXCVII	तीन सौ सत्तानबे
CCCXCVIII	तीन सौ अट्ठानबे
CCCXCIX	तीन सौ निन्यानबे
CD	चार सौ
CDI	चार सौ एक
CDII	चार सौ दो
CDIII	चार सौ तीन
CDIV	चार सौ चार
CDV	चार सौ पाँच
CDVI	चार सौ छह
CDVII	चार सौ सात
CDVIII	चार सौ आठ
CDIX	चार सौ नौ
CDX	चार सौ दस
CDXI	चार सौ ग्यारह
CDXII	चार सौ बारह
CDXIII	चार सौ तेरह
CDXIV	चार सौ चौदह
CDXV	चार सौ पंद्रह
CDXVI	चार सौ सोलह
CDXVII	चार सौ सत्रह
CDXVIII	चार सौ अठारह
CDXIX	चार सौ उन्नीस
CDXX	चार सौ बीस
CDXXI	चार सौ इक्कीस
CDXXII	चार सौ बाईस
CDXXIII	चार सौ तेईस
CDXXIV	चार सौ चौबीस
CDXXV	चार सौ पच्चीस
CDXXVI	चार सौ छब्बीस
CDXXVII	चार सौ सत्ताईस
CDXXVIII	चार सौ अट्ठाईस
CDXXIX	चार सौ उनतीस
CDXXX	चार सौ तीस
CDXXXI	चार सौ इकतीस
CDXXXII	चार सौ बत्तीस
CDXXXIII	चार सौ तैंतीस
CDXXXIV	चार सौ चौंतीस
CDXXXV	चार सौ पैंतीस
CDXXXVI	चार सौ छत्तीस
CDXXXVII	चार सौ सैंतीस
CDXXXVIII	चार सौ अड़तीस
CDXXXIX	चार सौ उनतालीस
CDXL	चार सौ चालीस
CDXLI	चार सौ इकतालीस
CDXLII	चार सौ बयालीस
CDXLIII	चार सौ तैंतालीस
CDXLIV	चार सौ चौवालीस
CDXLV	चार सौ पैंतालीस
CDXLVI	चार सौ छियालीस
CDXLVII	चार सौ सैंतालीस
CDXLVIII	चार सौ अड़तालीस
CDXLIX	चार सौ उनचास
CDL	चार सौ पचास
CDLI	चार सौ इक्यावन
CDLII	चार सौ बावन
CDLIII	चार सौ तिरेपन
CDLIV	चार सौ चौवन
CDLV	चार सौ पचपन
CDLVI	चार सौ छप्पन
CDLVII	चार सौ सत्तावन
CDLVIII	चार सौ अट्ठावन
CDLIX	चार सौ उनसठ
CDLX	चार सौ साठ
CDLXI	चार सौ इकसठ
CDLXII	चार सौ बासठ
CDLXIII	चार सौ तिरेसठ
CDLXIV	चार सौ चौंसठ
CDLXV	चार सौ पैंसठ
CDLXVI	चार सौ छियासठ
CDLXVII	चार सौ सड़सठ
CDLXVIII	चार सौ अड़सठ
CDLXIX	चार सौ उनहत्तर
CDLXX	चार सौ सत्तर
CDLXXI	चार सौ इकहत्तर
CDLXXII	चार सौ बहत्तर
CDLXXIII	चार सौ तिहत्तर
CDLXXIV	चार सौ चौहत्तर
CDLXXV	चार सौ पचहत्तर
CDLXXVI	चार सौ छिहत्तर
CDLXXVII	चार सौ सतहत्तर
CDLXXVIII	चार सौ अठहत्तर
CDLXXIX	चार सौ उनासी
CDLXXX	चार सौ अस्सी
CDLXXXI	चार सौ इक्यासी
CDLXXXII	चार सौ बयासी
CDLXXXIII	चार सौ तिरासी
CDLXXXIV	चार सौ चौरासी
CDLXXXV	चार सौ पचासी
CDLXXXVI	चार सौ छियासी
CDLXXXVII	चार सौ सत्तासी
CDLXXXVIII	चार सौ अट्ठासी
CDLXXXIX	चार सौ नवासी
CDXC	चार सौ नब्बे
CDXCI	चार सौ इक्यानबे
CDXCII	चार सौ बानबे
CDXCIII	चार सौ तिरानबे
CDXCIV	चार सौ चौरानबे
CDXCV	चार सौ पंचानबे
CDXCVI	चार सौ छियानबे
CDXCVII	चार सौ सत्तानबे
CDXCVIII	चार सौ अट्ठानबे
CDXCIX	चार सौ निन्यानबे
D	पाँच सौ
DI	पाँच सौ एक
DII	पाँच सौ दो
DIII	पाँच सौ तीन
DIV	पाँच सौ चार
DV	पाँच सौ पाँच
DVI	पाँच सौ छह
DVII	पाँच सौ सात
DVIII	पाँच सौ आठ
DIX	पाँच सौ नौ
DX	पाँच सौ दस
DXI	पाँच सौ ग्यारह
DXII	पाँच सौ बारह
DXIII	पाँच सौ तेरह
DXIV	पाँच सौ चौदह
DXV	पाँच सौ पंद्रह
DXVI	पाँच सौ सोलह
DXVII	पाँच सौ सत्रह
DXVIII	पाँच सौ अठारह
DXIX	पाँच सौ उन्नीस
DXX	पाँच सौ बीस
DXXI	पाँच सौ इक्कीस
DXXII	पाँच सौ बाईस
DXXIII	पाँच सौ तेईस
DXXIV	पाँच सौ चौबीस
DXXV	पाँच सौ पच्चीस
DXXVI	पाँच सौ छब्बीस
DXXVII	पाँच सौ सत्ताईस
DXXVIII	पाँच सौ अट्ठाईस
DXXIX	पाँच सौ उनतीस
DXXX	पाँच सौ तीस
DXXXI	पाँच सौ इकतीस
DXXXII	पाँच सौ बत्तीस
DXXXIII	पाँच सौ तैंतीस
DXXXIV	पाँच सौ चौंतीस
DXXXV	पाँच सौ पैंतीस
DXXXVI	पाँच सौ छत्तीस
DXXXVII	पाँच सौ सैंतीस
DXXXVIII	पाँच सौ अड़तीस
DXXXIX	पाँच सौ उनतालीस
DXL	पाँच सौ चालीस
DXLI	पाँच सौ इकतालीस
DXLII	पाँच सौ बयालीस
DXLIII	पाँच सौ तैंतालीस
DXLIV	पाँच सौ चौवालीस
DXLV	पाँच सौ पैंतालीस
DXLVI	पाँच सौ छियालीस
DXLVII	पाँच सौ सैंतालीस
DXLVIII	पाँच सौ अड़तालीस
DXLIX	पाँच सौ उनचास
DL	पाँच सौ पचास
DLI	पाँच सौ इक्यावन
DLII	पाँच सौ बावन
DLIII	पाँच सौ तिरेपन
DLIV	पाँच सौ चौवन
DLV	पाँच सौ पचपन
DLVI	पाँच सौ छप्पन
DLVII	पाँच सौ सत्तावन
DLVIII	पाँच सौ अट्ठावन
DLIX	पाँच सौ उनसठ
DLX	पाँच सौ साठ
DLXI	पाँच सौ इकसठ
DLXII	पाँच सौ बासठ
DLXIII	पाँच सौ तिरेसठ
DLXIV	पाँच सौ चौंसठ
DLXV	पाँच सौ पैंसठ
DLXVI	पाँच सौ छियासठ
DLXVII	पाँच सौ सड़सठ
DLXVIII	पाँच सौ अड़सठ
DLXIX	पाँच सौ उनहत्तर
DLXX	पाँच सौ सत्तर
DLXXI	पाँच सौ इकहत्तर
DLXXII	पाँच सौ बहत्तर
DLXXIII	पाँच सौ तिहत्तर
DLXXIV	पाँच सौ चौहत्तर
DLXXV	पाँच सौ पचहत्तर
DLXXVI	पाँच सौ छिहत्तर
DLXXVII	पाँच सौ सतहत्तर
DLXXVIII	पाँच सौ अठहत्तर
DLXXIX	पाँच सौ उनासी
DLXXX	पाँच सौ अस्सी
DLXXXI	पाँच सौ इक्यासी
DLXXXII	पाँच सौ बयासी
DLXXXIII	पाँच सौ तिरासी
DLXXXIV	पाँच सौ चौरासी
DLXXXV	पाँच सौ पचासी
DLXXXVI	पाँच सौ छियासी
DLXXXVII	पाँच सौ सत्तासी
DLXXXVIII	पाँच सौ अट्ठासी
DLXXXIX	पाँच सौ नवासी
DXC	पाँच सौ नब्बे
DXCI	पाँच सौ इक्यानबे
DXCII	पाँच सौ बानबे
DXCIII	पाँच सौ तिरानबे
DXCIV	पाँच सौ चौरानबे
DXCV	पाँच सौ पंचानबे
DXCVI	पाँच सौ छियानबे
DXCVII	पाँच सौ सत्तानबे
DXCVIII	पाँच सौ अट्ठानबे
DXCIX	पाँच सौ निन्यानबे
DC	छह सौ
DCI	छह सौ एक
DCII	छह सौ दो
DCIII	छह सौ तीन
DCIV	छह सौ चार
DCV	छह सौ पाँच
DCVI	छह सौ छह
DCVII	छह सौ सात
DCVIII	छह सौ आठ
DCIX	छह सौ नौ
DCX	छह सौ दस
DCXI	छह सौ ग्यारह
DCXII	छह सौ बारह
DCXIII	छह सौ तेरह
DCXIV	छह सौ चौदह
DCXV	छह सौ पंद्रह
DCXVI	छह सौ सोलह
DCXVII	छह सौ सत्रह
DCXVIII	छह सौ अठारह
DCXIX	छह सौ उन्नीस
DCXX	छह सौ बीस
DCXXI	छह सौ इक्कीस
DCXXII	छह सौ बाईस
DCXXIII	छह सौ तेईस
DCXXIV	छह सौ चौबीस
DCXXV	छह सौ पच्चीस
DCXXVI	छह सौ छब्बीस
DCXXVII	छह सौ सत्ताईस
DCXXVIII	छह सौ अट्ठाईस
DCXXIX	छह सौ उनतीस
DCXXX	छह सौ तीस
DCXXXI	छह सौ इकतीस
DCXXXII	छह सौ बत्तीस
DCXXXIII	छह सौ तैंतीस
DCXXXIV	छह सौ चौंतीस
DCXXXV	छह सौ पैंतीस
DCXXXVI	छह सौ छत्तीस
DCXXXVII	छह सौ सैंतीस
DCXXXVIII	छह सौ अड़तीस
DCXXXIX	छह सौ उनतालीस
DCXL	छह सौ चालीस
DCXLI	छह सौ इकतालीस
DCXLII	छह सौ बयालीस
DCXLIII	छह सौ तैंतालीस
DCXLIV	छह सौ चौवालीस
DCXLV	छह सौ पैंतालीस
DCXLVI	छह सौ छियालीस
DCXLVII	छह सौ सैंतालीस
DCXLVIII	छह सौ अड़तालीस
DCXLIX	छह सौ उनचास
DCL	छह सौ पचास
DCLI	छह सौ इक्यावन
DCLII	छह सौ बावन
DCLIII	छह सौ तिरेपन
DCLIV	छह सौ चौवन
DCLV	छह सौ पचपन
DCLVI	छह सौ छप्पन
DCLVII	छह सौ सत्तावन
DCLVIII	छह सौ अट्ठावन
DCLIX	छह सौ उनसठ
DCLX	छह सौ साठ
DCLXI	छह सौ इकसठ
DCLXII	छह सौ बासठ
DCLXIII	छह सौ तिरेसठ
DCLXIV	छह सौ चौंसठ
DCLXV	छह सौ पैंसठ
DCLXVI	छह सौ छियासठ
DCLXVII	छह सौ सड़सठ
DCLXVIII	छह सौ अड़सठ
DCLXIX	छह सौ उनहत्तर
DCLXX	छह सौ सत्तर
DCLXXI	छह सौ इकहत्तर
DCLXXII	छह सौ बहत्तर
DCLXXIII	छह सौ तिहत्तर
DCLXXIV	छह सौ चौहत्तर
DCLXXV	छह सौ पचहत्तर
DCLXXVI	छह सौ छिहत्तर
DCLXXVII	छह सौ सतहत्तर
DCLXXVIII	छह सौ अठहत्तर
DCLXXIX	छह सौ उनासी
DCLXXX	छह सौ अस्सी
DCLXXXI	छह सौ इक्यासी
DCLXXXII	छह सौ बयासी
DCLXXXIII	छह सौ तिरासी
DCLXXXIV	छह सौ चौरासी
DCLXXXV	छह सौ पचासी
DCLXXXVI	छह सौ छियासी
DCLXXXVII	छह सौ सत्तासी
DCLXXXVIII	छह सौ अट्ठासी
DCLXXXIX	छह सौ नवासी
DCXC	छह सौ नब्बे
DCXCI	छह सौ इक्यानबे
DCXCII	छह सौ बानबे
DCXCIII	छह सौ तिरानबे
DCXCIV	छह सौ चौरानबे
DCXCV	छह सौ पंचानबे
DCXCVI	छह सौ छियानबे
DCXCVII	छह सौ सत्तानबे
DCXCVIII	छह सौ अट्ठानबे
DCXCIX	छह सौ निन्यानबे
DCC	सात सौ
DCCI	सात सौ एक
DCCII	सात सौ दो
DCCIII	सात सौ तीन
DCCIV	सात सौ चार
DCCV	सात सौ पाँच
DCCVI	सात सौ छह
DCCVII	सात सौ सात
DCCVIII	सात सौ आठ
DCCIX	सात सौ नौ
DCCX	सात सौ दस
DCCXI	सात सौ ग्यारह
DCCXII	सात सौ बारह
DCCXIII	सात सौ तेरह
DCCXIV	सात सौ चौदह
DCCXV	सात सौ पंद्रह
DCCXVI	सात सौ सोलह
DCCXVII	सात सौ सत्रह
DCCXVIII	सात सौ अठारह
DCCXIX	सात सौ उन्नीस
DCCXX	सात सौ बीस
DCCXXI	सात सौ इक्कीस
DCCXXII	सात सौ बाईस
DCCXXIII	सात सौ तेईस
DCCXXIV	सात सौ चौबीस
DCCXXV	सात सौ पच्चीस
DCCXXVI	सात सौ छब्बीस
DCCXXVII	सात सौ सत्ताईस
DCCXXVIII	सात सौ अट्ठाईस
DCCXXIX	सात सौ उनतीस
DCCXXX	सात सौ तीस
DCCXXXI	सात सौ इकतीस
DCCXXXII	सात सौ बत्तीस
DCCXXXIII	सात सौ तैंतीस
DCCXXXIV	सात सौ चौंतीस
DCCXXXV	सात सौ पैंतीस
DCCXXXVI	सात सौ छत्तीस
DCCXXXVII	सात सौ सैंतीस
DCCXXXVIII	सात सौ अड़तीस
DCCXXXIX	सात सौ उनतालीस
DCCXL	सात सौ चालीस
DCCXLI	सात सौ इकतालीस
DCCXLII	सात सौ बयालीस
DCCXLIII	सात सौ तैंतालीस
DCCXLIV	सात सौ चौवालीस
DCCXLV	सात सौ पैंतालीस
DCCXLVI	सात सौ छियालीस
DCCXLVII	सात सौ सैंतालीस
DCCXLVIII	सात सौ अड़तालीस
DCCXLIX	सात सौ उनचास
DCCL	सात सौ पचास
DCCLI	सात सौ इक्यावन
DCCLII	सात सौ बावन
DCCLIII	सात सौ तिरेपन
DCCLIV	सात सौ चौवन
DCCLV	सात सौ पचपन
DCCLVI	सात सौ छप्पन
DCCLVII	सात सौ सत्तावन
DCCLVIII	सात सौ अट्ठावन
DCCLIX	सात सौ उनसठ
DCCLX	सात सौ साठ
DCCLXI	सात सौ इकसठ
DCCLXII	सात सौ बासठ
DCCLXIII	सात सौ तिरेसठ
DCCLXIV	सात सौ चौंसठ
DCCLXV	सात सौ पैंसठ
DCCLXVI	सात सौ छियासठ
DCCLXVII	सात सौ सड़सठ
DCCLXVIII	सात सौ अड़सठ
DCCLXIX	सात सौ उनहत्तर
DCCLXX	सात सौ सत्तर
DCCLXXI	सात सौ इकहत्तर
DCCLXXII	सात सौ बहत्तर
DCCLXXIII	सात सौ तिहत्तर
DCCLXXIV	सात सौ चौहत्तर
DCCLXXV	सात सौ पचहत्तर
DCCLXXVI	सात सौ छिहत्तर
DCCLXXVII	सात सौ सतहत्तर
DCCLXXVIII	सात सौ अठहत्तर
DCCLXXIX	सात सौ उनासी
DCCLXXX	सात सौ अस्सी
DCCLXXXI	सात सौ इक्यासी
DCCLXXXII	सात सौ बयासी
DCCLXXXIII	सात सौ तिरासी
DCCLXXXIV	सात सौ चौरासी
DCCLXXXV	सात सौ पचासी
DCCLXXXVI	सात सौ छियासी
DCCLXXXVII	सात सौ सत्तासी
DCCLXXXVIII	सात सौ अट्ठासी
DCCLXXXIX	सात सौ नवासी
DCCXC	सात सौ नब्बे
DCCXCI	सात सौ इक्यानबे
DCCXCII	सात सौ बानबे
DCCXCIII	सात सौ तिरानबे
DCCXCIV	सात सौ चौरानबे
DCCXCV	सात सौ पंचानबे
DCCXCVI	सात सौ छियानबे
DCCXCVII	सात सौ सत्तानबे
DCCXCVIII	सात सौ अट्ठानबे
DCCXCIX	सात सौ निन्यानबे
DCCC	आठ सौ
DCCCI	आठ सौ एक
DCCCII	आठ सौ दो
DCCCIII	आठ सौ तीन
DCCCIV	आठ सौ चार
DCCCV	आठ सौ पाँच
DCCCVI	आठ सौ छह
DCCCVII	आठ सौ सात
DCCCVIII	आठ सौ आठ
DCCCIX	आठ सौ नौ
DCCCX	आठ सौ दस
DCCCXI	आठ सौ ग्यारह
DCCCXII	आठ सौ बारह
DCCCXIII	आठ सौ तेरह
DCCCXIV	आठ सौ चौदह
DCCCXV	आठ सौ पंद्रह
DCCCXVI	आठ सौ सोलह
DCCCXVII	आठ सौ सत्रह
DCCCXVIII	आठ सौ अठारह
DCCCXIX	आठ सौ उन्नीस
DCCCXX	आठ सौ बीस
DCCCXXI	आठ सौ इक्कीस
DCCCXXII	आठ सौ बाईस
DCCCXXIII	आठ सौ तेईस
DCCCXXIV	आठ सौ चौबीस
DCCCXXV	आठ सौ पच्चीस
DCCCXXVI	आठ सौ छब्बीस
DCCCXXVII	आठ सौ सत्ताईस
DCCCXXVIII	आठ सौ अट्ठाईस
DCCCXXIX	आठ सौ उनतीस
DCCCXXX	आठ सौ तीस
DCCCXXXI	आठ सौ इकतीस
DCCCXXXII	आठ सौ बत्तीस
DCCCXXXIII	आठ सौ तैंतीस
DCCCXXXIV	आठ सौ चौंतीस
DCCCXXXV	आठ सौ पैंतीस
DCCCXXXVI	आठ सौ छत्तीस
DCCCXXXVII	आठ सौ सैंतीस
DCCCXXXVIII	आठ सौ अड़तीस
DCCCXXXIX	आठ सौ उनतालीस
DCCCXL	आठ सौ चालीस
DCCCXLI	आठ सौ इकतालीस
DCCCXLII	आठ सौ बयालीस
DCCCXLIII	आठ सौ तैंतालीस
DCCCXLIV	आठ सौ चौवालीस
DCCCXLV	आठ सौ पैंतालीस
DCCCXLVI	आठ सौ छियालीस
DCCCXLVII	आठ सौ सैंतालीस
DCCCXLVIII	आठ सौ अड़तालीस
DCCCXLIX	आठ सौ उनचास
DCCCL	आठ सौ पचास
DCCCLI	आठ सौ इक्यावन
DCCCLII	आठ सौ बावन
DCCCLIII	आठ सौ तिरेपन
DCCCLIV	आठ सौ चौवन
DCCCLV	आठ सौ पचपन
DCCCLVI	आठ सौ छप्पन
DCCCLVII	आठ सौ सत्तावन
DCCCLVIII	आठ सौ अट्ठावन
DCCCLIX	आठ सौ उनसठ
DCCCLX	आठ सौ साठ
DCCCLXI	आठ सौ इकसठ
DCCCLXII	आठ सौ बासठ
DCCCLXIII	आठ सौ तिरेसठ
DCCCLXIV	आठ सौ चौंसठ
DCCCLXV	आठ सौ पैंसठ
DCCCLXVI	आठ सौ छियासठ
DCCCLXVII	आठ सौ सड़सठ
DCCCLXVIII	आठ सौ अड़सठ
DCCCLXIX	आठ सौ उनहत्तर
DCCCLXX	आठ सौ सत्तर
DCCCLXXI	आठ सौ इकहत्तर
DCCCLXXII	आठ सौ बहत्तर
DCCCLXXIII	आठ सौ तिहत्तर
DCCCLXXIV	आठ सौ चौहत्तर
DCCCLXXV	आठ सौ पचहत्तर
DCCCLXXVI	आठ सौ छिहत्तर
DCCCLXXVII	आठ सौ सतहत्तर
DCCCLXXVIII	आठ सौ अठहत्तर
DCCCLXXIX	आठ सौ उनासी
DCCCLXXX	आठ सौ अस्सी
DCCCLXXXI	आठ सौ इक्यासी
DCCCLXXXII	आठ सौ बयासी
DCCCLXXXIII	आठ सौ तिरासी
DCCCLXXXIV	आठ सौ चौरासी
DCCCLXXXV	आठ सौ पचासी
DCCCLXXXVI	आठ सौ छियासी
DCCCLXXXVII	आठ सौ सत्तासी
DCCCLXXXVIII	आठ सौ अट्ठासी
DCCCLXXXIX	आठ सौ नवासी
DCCCXC	आठ सौ नब्बे
DCCCXCI	आठ सौ इक्यानबे
DCCCXCII	आठ सौ बानबे
DCCCXCIII	आठ सौ तिरानबे
DCCCXCIV	आठ सौ चौरानबे
DCCCXCV	आठ सौ पंचानबे
DCCCXCVI	आठ सौ छियानबे
DCCCXCVII	आठ सौ सत्तानबे
DCCCXCVIII	आठ सौ अट्ठानबे
DCCCXCIX	आठ सौ निन्यानबे
CM	नौ सौ
CMI	नौ सौ एक
CMII	नौ सौ दो
CMIII	नौ सौ तीन
CMIV	नौ सौ चार
CMV	नौ सौ पाँच
CMVI	नौ सौ छह
CMVII	नौ सौ सात
CMVIII	नौ सौ आठ
CMIX	नौ सौ नौ
CMX	नौ सौ दस
CMXI	नौ सौ ग्यारह
CMXII	नौ सौ बारह
CMXIII	नौ सौ तेरह
CMXIV	नौ सौ चौदह
CMXV	नौ सौ पंद्रह
CMXVI	नौ सौ सोलह
CMXVII	नौ सौ सत्रह
CMXVIII	नौ सौ अठारह
CMXIX	नौ सौ उन्नीस
CMXX	नौ सौ बीस
CMXXI	नौ सौ इक्कीस
CMXXII	नौ सौ बाईस
CMXXIII	नौ सौ तेईस
CMXXIV	नौ सौ चौबीस
CMXXV	नौ सौ पच्चीस
CMXXVI	नौ सौ छब्बीस
CMXXVII	नौ सौ सत्ताईस
CMXXVIII	नौ सौ अट्ठाईस
CMXXIX	नौ सौ उनतीस
CMXXX	नौ सौ तीस
CMXXXI	नौ सौ इकतीस
CMXXXII	नौ सौ बत्तीस
CMXXXIII	नौ सौ तैंतीस
CMXXXIV	नौ सौ चौंतीस
CMXXXV	नौ सौ पैंतीस
CMXXXVI	नौ सौ छत्तीस
CMXXXVII	नौ सौ सैंतीस
CMXXXVIII	नौ सौ अड़तीस
CMXXXIX	नौ सौ उनतालीस
CMXL	नौ सौ चालीस
CMXLI	नौ सौ इकतालीस
CMXLII	नौ सौ बयालीस
CMXLIII	नौ सौ तैंतालीस
CMXLIV	नौ सौ चौवालीस
CMXLV	नौ सौ पैंतालीस
CMXLVI	नौ सौ छियालीस
CMXLVII	नौ सौ सैंतालीस
CMXLVIII	नौ सौ अड़तालीस
CMXLIX	नौ सौ उनचास
CML	नौ सौ पचास
CMLI	नौ सौ इक्यावन
CMLII	नौ सौ बावन
CMLIII	नौ सौ तिरेपन
CMLIV	नौ सौ चौवन
CMLV	नौ सौ पचपन
CMLVI	नौ सौ छप्पन
CMLVII	नौ सौ सत्तावन
CMLVIII	नौ सौ अट्ठावन
CMLIX	नौ सौ उनसठ
CMLX	नौ सौ साठ
CMLXI	नौ सौ इकसठ
CMLXII	नौ सौ बासठ
CMLXIII	नौ सौ तिरेसठ
CMLXIV	नौ सौ चौंसठ
CMLXV	नौ सौ पैंसठ
CMLXVI	नौ सौ छियासठ
CMLXVII	नौ सौ सड़सठ
CMLXVIII	नौ सौ अड़सठ
CMLXIX	नौ सौ उनहत्तर
CMLXX	नौ सौ सत्तर
CMLXXI	नौ सौ इकहत्तर
CMLXXII	नौ सौ बहत्तर
CMLXXIII	नौ सौ तिहत्तर
CMLXXIV	नौ सौ चौहत्तर
CMLXXV	नौ सौ पचहत्तर
CMLXXVI	नौ सौ छिहत्तर
CMLXXVII	नौ सौ सतहत्तर
CMLXXVIII	नौ सौ अठहत्तर
CMLXXIX	नौ सौ उनासी
CMLXXX	नौ सौ अस्सी
CMLXXXI	नौ सौ इक्यासी
CMLXXXII	नौ सौ बयासी
CMLXXXIII	नौ सौ तिरासी
CMLXXXIV	नौ सौ चौरासी
CMLXXXV	नौ सौ पचासी
CMLXXXVI	नौ सौ छियासी
CMLXXXVII	नौ सौ सत्तासी
CMLXXXVIII	नौ सौ अट्ठासी
CMLXXXIX	नौ सौ नवासी
CMXC	नौ सौ नब्बे
CMXCI	नौ सौ इक्यानबे
CMXCII	नौ सौ बानबे
CMXCIII	नौ सौ तिरानबे
CMXCIV	नौ सौ चौरानबे
CMXCV	नौ सौ पंचानबे
CMXCVI	नौ सौ छियानबे
CMXCVII	नौ सौ सत्तानबे
CMXCVIII	नौ सौ अट्ठानबे
CMXCIX	नौ सौ निन्यानबे
M	एक हज़ार
MI	एक हज़ार एक
MII	एक हज़ार दो
MIII	एक हज़ार तीन
MIV	एक हज़ार चार
MV	एक हज़ार पाँच
MVI	एक हज़ार छह
MVII	एक हज़ार सात
MVIII	एक हज़ार आठ
MIX	एक हज़ार नौ
MX	एक हज़ार दस
MXI	एक हज़ार ग्यारह
MXII	एक हज़ार बारह
MXIII	एक हज़ार तेरह
MXIV	एक हज़ार चौदह
MXV	एक हज़ार पंद्रह
MXVI	एक हज़ार सोलह
MXVII	एक हज़ार सत्रह
MXVIII	एक हज़ार अठारह
MXIX	एक हज़ार उन्नीस
MXX	एक हज़ार बीस
MXXI	एक हज़ार इक्कीस
MXXII	एक हज़ार बाईस
MXXIII	एक हज़ार तेईस
MXXIV	एक हज़ार चौबीस
MXXV	एक हज़ार पच्चीस
MXXVI	एक हज़ार छब्बीस
MXXVII	एक हज़ार सत्ताईस
MXXVIII	एक हज़ार अट्ठाईस
MXXIX	एक हज़ार उनतीस
MXXX	एक हज़ार तीस
MXXXI	एक हज़ार इकतीस
MXXXII	एक हज़ार बत्तीस
MXXXIII	एक हज़ार तैंतीस
MXXXIV	एक हज़ार चौंतीस
MXXXV	एक हज़ार पैंतीस
MXXXVI	एक हज़ार छत्तीस
MXXXVII	एक हज़ार सैंतीस
MXXXVIII	एक हज़ार अड़तीस
MXXXIX	एक हज़ार उनतालीस
MXL	एक हज़ार चालीस
MXLI	एक हज़ार इकतालीस
MXLII	एक हज़ार बयालीस
MXLIII	एक हज़ार तैंतालीस
MXLIV	एक हज़ार चौवालीस
MXLV	एक हज़ार पैंतालीस
MXLVI	एक हज़ार छियालीस
MXLVII	एक हज़ार सैंतालीस
MXLVIII	एक हज़ार अड़तालीस
MXLIX	एक हज़ार उनचास
ML	एक हज़ार पचास
MLI	एक हज़ार इक्यावन
MLII	एक हज़ार बावन
MLIII	एक हज़ार तिरेपन
MLIV	एक हज़ार चौवन
MLV	एक हज़ार पचपन
MLVI	एक हज़ार छप्पन
MLVII	एक हज़ार सत्तावन
MLVIII	एक हज़ार अट्ठावन
MLIX	एक हज़ार उनसठ
MLX	एक हज़ार साठ
MLXI	एक हज़ार इकसठ
MLXII	एक हज़ार बासठ
MLXIII	एक हज़ार तिरेसठ
MLXIV	एक हज़ार चौंसठ
MLXV	एक हज़ार पैंसठ
MLXVI	एक हज़ार छियासठ
MLXVII	एक हज़ार सड़सठ
MLXVIII	एक हज़ार अड़सठ
MLXIX	एक हज़ार उनहत्तर
MLXX	एक हज़ार सत्तर
MLXXI	एक हज़ार इकहत्तर
MLXXII	एक हज़ार बहत्तर
MLXXIII	एक हज़ार तिहत्तर
MLXXIV	एक हज़ार चौहत्तर
MLXXV	एक हज़ार पचहत्तर
MLXXVI	एक हज़ार छिहत्तर
MLXXVII	एक हज़ार सतहत्तर
MLXXVIII	एक हज़ार अठहत्तर
MLXXIX	एक हज़ार उनासी
MLXXX	एक हज़ार अस्सी
MLXXXI	एक हज़ार इक्यासी
MLXXXII	एक हज़ार बयासी
MLXXXIII	एक हज़ार तिरासी
MLXXXIV	एक हज़ार चौरासी
MLXXXV	एक हज़ार पचासी
MLXXXVI	एक हज़ार छियासी
MLXXXVII	एक हज़ार सत्तासी
MLXXXVIII	एक हज़ार अट्ठासी
MLXXXIX	एक हज़ार नवासी
MXC	एक हज़ार नब्बे
MXCI	एक हज़ार इक्यानबे
MXCII	एक हज़ार बानबे
MXCIII	एक हज़ार तिरानबे
MXCIV	एक हज़ार चौरानबे
MXCV	एक हज़ार पंचानबे
MXCVI	एक हज़ार छियानबे
MXCVII	एक हज़ार सत्तानबे
MXCVIII	एक हज़ार अट्ठानबे
MXCIX	एक हज़ार निन्यानबे
MC	एक हज़ार एक सौ
MCI	एक हज़ार एक सौ एक
MCII	एक हज़ार एक सौ दो
MCIII	एक हज़ार एक सौ तीन
MCIV	एक हज़ार एक सौ चार
MCV	एक हज़ार एक सौ पाँच
MCVI	एक हज़ार एक सौ छह
MCVII	एक हज़ार एक सौ सात
MCVIII	एक हज़ार एक सौ आठ
MCIX	एक हज़ार एक सौ नौ
MCX	एक हज़ार एक सौ दस
MCXI	एक हज़ार एक सौ ग्यारह
MCXII	एक हज़ार एक सौ बारह
MCXIII	एक हज़ार एक सौ तेरह
MCXIV	एक हज़ार एक सौ चौदह
MCXV	एक हज़ार एक सौ पंद्रह
MCXVI	एक हज़ार एक सौ सोलह
MCXVII	एक हज़ार एक सौ सत्रह
MCXVIII	एक हज़ार एक सौ अठारह
MCXIX	एक हज़ार एक सौ उन्नीस
MCXX	एक हज़ार एक सौ बीस
MCXXI	एक हज़ार एक सौ इक्कीस
MCXXII	एक हज़ार एक सौ बाईस
MCXXIII	एक हज़ार एक सौ तेईस
MCXXIV	एक हज़ार एक सौ चौबीस
MCXXV	एक हज़ार एक सौ पच्चीस
MCXXVI	एक हज़ार एक सौ छब्बीस
MCXXVII	एक हज़ार एक सौ सत्ताईस
MCXXVIII	एक हज़ार एक सौ अट्ठाईस
MCXXIX	एक हज़ार एक सौ उनतीस
MCXXX	एक हज़ार एक सौ तीस
MCXXXI	एक हज़ार एक सौ इकतीस
MCXXXII	एक हज़ार एक सौ बत्तीस
MCXXXIII	एक हज़ार एक सौ तैंतीस
MCXXXIV	एक हज़ार एक सौ चौंतीस
MCXXXV	एक हज़ार एक सौ पैंतीस
MCXXXVI	एक हज़ार एक सौ छत्तीस
MCXXXVII	एक हज़ार एक सौ सैंतीस
MCXXXVIII	एक हज़ार एक सौ अड़तीस
MCXXXIX	एक हज़ार एक सौ उनतालीस
MCXL	एक हज़ार एक सौ चालीस
MCXLI	एक हज़ार एक सौ इकतालीस
MCXLII	एक हज़ार एक सौ बयालीस
MCXLIII	एक हज़ार एक सौ तैंतालीस
MCXLIV	एक हज़ार एक सौ चौवालीस
MCXLV	एक हज़ार एक सौ पैंतालीस
MCXLVI	एक हज़ार एक सौ छियालीस
MCXLVII	एक हज़ार एक सौ सैंतालीस
MCXLVIII	एक हज़ार एक सौ अड़तालीस
MCXLIX	एक हज़ार एक सौ उनचास
MCL	एक हज़ार एक सौ पचास
MCLI	एक हज़ार एक सौ इक्यावन
MCLII	एक हज़ार एक सौ बावन
MCLIII	एक हज़ार एक सौ तिरेपन
MCLIV	एक हज़ार एक सौ चौवन
MCLV	एक हज़ार एक सौ पचपन
MCLVI	एक हज़ार एक सौ छप्पन
MCLVII	एक हज़ार एक सौ सत्तावन
MCLVIII	एक हज़ार एक सौ अट्ठावन
MCLIX	एक हज़ार एक सौ उनसठ
MCLX	एक हज़ार एक सौ साठ
MCLXI	एक हज़ार एक सौ इकसठ
MCLXII	एक हज़ार एक सौ बासठ
MCLXIII	एक हज़ार एक सौ तिरेसठ
MCLXIV	एक हज़ार एक सौ चौंसठ
MCLXV	एक हज़ार एक सौ पैंसठ
MCLXVI	एक हज़ार एक सौ छियासठ
MCLXVII	एक हज़ार एक सौ सड़सठ
MCLXVIII	एक हज़ार एक सौ अड़सठ
MCLXIX	एक हज़ार एक सौ उनहत्तर
MCLXX	एक हज़ार एक सौ सत्तर
MCLXXI	एक हज़ार एक सौ इकहत्तर
MCLXXII	एक हज़ार एक सौ बहत्तर
MCLXXIII	एक हज़ार एक सौ तिहत्तर
MCLXXIV	एक हज़ार एक सौ चौहत्तर
MCLXXV	एक हज़ार एक सौ पचहत्तर
MCLXXVI	एक हज़ार एक सौ छिहत्तर
MCLXXVII	एक हज़ार एक सौ सतहत्तर
MCLXXVIII	एक हज़ार एक सौ अठहत्तर
MCLXXIX	एक हज़ार एक सौ उनासी
MCLXXX	एक हज़ार एक सौ अस्सी
MCLXXXI	एक हज़ार एक सौ इक्यासी
MCLXXXII	एक हज़ार एक सौ बयासी
MCLXXXIII	एक हज़ार एक सौ तिरासी
MCLXXXIV	एक हज़ार एक सौ चौरासी
MCLXXXV	एक हज़ार एक सौ पचासी
MCLXXXVI	एक हज़ार एक सौ छियासी
MCLXXXVII	एक हज़ार एक सौ सत्तासी
MCLXXXVIII	एक हज़ार एक सौ अट्ठासी
MCLXXXIX	एक हज़ार एक सौ नवासी
MCXC	एक हज़ार एक सौ नब्बे
MCXCI	एक हज़ार एक सौ इक्यानबे
MCXCII	एक हज़ार एक सौ बानबे
MCXCIII	एक हज़ार एक सौ तिरानबे
MCXCIV	एक हज़ार एक सौ चौरानबे
MCXCV	एक हज़ार एक सौ पंचानबे
MCXCVI	एक हज़ार एक सौ छियानबे
MCXCVII	एक हज़ार एक सौ सत्तानबे
MCXCVIII	एक हज़ार एक सौ अट्ठानबे
MCXCIX	एक हज़ार एक सौ निन्यानबे
MCC	एक हज़ार दो सौ
MCCI	एक हज़ार दो सौ एक
MCCII	एक हज़ार दो सौ दो
MCCIII	एक हज़ार दो सौ तीन
MCCIV	एक हज़ार दो सौ चार
MCCV	एक हज़ार दो सौ पाँच
MCCVI	एक हज़ार दो सौ छह
MCCVII	एक हज़ार दो सौ सात
MCCVIII	एक हज़ार दो सौ आठ
MCCIX	एक हज़ार दो सौ नौ
MCCX	एक हज़ार दो सौ दस
MCCXI	एक हज़ार दो सौ ग्यारह
MCCXII	एक हज़ार दो सौ बारह
MCCXIII	एक हज़ार दो सौ तेरह
MCCXIV	एक हज़ार दो सौ चौदह
MCCXV	एक हज़ार दो सौ पंद्रह
MCCXVI	एक हज़ार दो सौ सोलह
MCCXVII	एक हज़ार दो सौ सत्रह
MCCXVIII	एक हज़ार दो सौ अठारह
MCCXIX	एक हज़ार दो सौ उन्नीस
MCCXX	एक हज़ार दो सौ बीस
MCCXXI	एक हज़ार दो सौ इक्कीस
MCCXXII	एक हज़ार दो सौ बाईस
MCCXXIII	एक हज़ार दो सौ तेईस
MCCXXIV	एक हज़ार दो सौ चौबीस
MCCXXV	एक हज़ार दो सौ पच्चीस
MCCXXVI	एक हज़ार दो सौ छब्बीस
MCCXXVII	एक हज़ार दो सौ सत्ताईस
MCCXXVIII	एक हज़ार दो सौ अट्ठाईस
MCCXXIX	एक हज़ार दो सौ उनतीस
MCCXXX	एक हज़ार दो सौ तीस
MCCXXXI	एक हज़ार दो सौ इकतीस
MCCXXXII	एक हज़ार दो सौ बत्तीस
MCCXXXIII	एक हज़ार दो सौ तैंतीस
MCCXXXIV	एक हज़ार दो सौ चौंतीस
MCCXXXV	एक हज़ार दो सौ पैंतीस
MCCXXXVI	एक हज़ार दो सौ छत्तीस
MCCXXXVII	एक हज़ार दो सौ सैंतीस
MCCXXXVIII	एक हज़ार दो सौ अड़तीस
MCCXXXIX	एक हज़ार दो सौ उनतालीस
MCCXL	एक हज़ार दो सौ चालीस
MCCXLI	एक हज़ार दो सौ इकतालीस
MCCXLII	एक हज़ार दो सौ बयालीस
MCCXLIII	एक हज़ार दो सौ तैंतालीस
MCCXLIV	एक हज़ार दो सौ चौवालीस
MCCXLV	एक हज़ार दो सौ पैंतालीस
MCCXLVI	एक हज़ार दो सौ छियालीस
MCCXLVII	एक हज़ार दो सौ सैंतालीस
MCCXLVIII	एक हज़ार दो सौ अड़तालीस
MCCXLIX	एक हज़ार दो सौ उनचास
MCCL	एक हज़ार दो सौ पचास
MCCLI	एक हज़ार दो सौ इक्यावन
MCCLII	एक हज़ार दो सौ बावन
MCCLIII	एक हज़ार दो सौ तिरेपन
MCCLIV	एक हज़ार दो सौ चौवन
MCCLV	एक हज़ार दो सौ पचपन
MCCLVI	एक हज़ार दो सौ छप्पन
MCCLVII	एक हज़ार दो सौ सत्तावन
MCCLVIII	एक हज़ार दो सौ अट्ठावन
MCCLIX	एक हज़ार दो सौ उनसठ
MCCLX	एक हज़ार दो सौ साठ
MCCLXI	एक हज़ार दो सौ इकसठ
MCCLXII	एक हज़ार दो सौ बासठ
MCCLXIII	एक हज़ार दो सौ तिरेसठ
MCCLXIV	एक हज़ार दो सौ चौंसठ
MCCLXV	एक हज़ार दो सौ पैंसठ
MCCLXVI	एक हज़ार दो सौ छियासठ
MCCLXVII	एक हज़ार दो सौ सड़सठ
MCCLXVIII	एक हज़ार दो सौ अड़सठ
MCCLXIX	एक हज़ार दो सौ उनहत्तर
MCCLXX	एक हज़ार दो सौ सत्तर
MCCLXXI	एक हज़ार दो सौ इकहत्तर
MCCLXXII	एक हज़ार दो सौ बहत्तर
MCCLXXIII	एक हज़ार दो सौ तिहत्तर
MCCLXXIV	एक हज़ार दो सौ चौहत्तर
MCCLXXV	एक हज़ार दो सौ पचहत्तर
MCCLXXVI	एक हज़ार दो सौ छिहत्तर
MCCLXXVII	एक हज़ार दो सौ सतहत्तर
MCCLXXVIII	एक हज़ार दो सौ अठहत्तर
MCCLXXIX	एक हज़ार दो सौ उनासी
MCCLXXX	एक हज़ार दो सौ अस्सी
MCCLXXXI	एक हज़ार दो सौ इक्यासी
MCCLXXXII	एक हज़ार दो सौ बयासी
MCCLXXXIII	एक हज़ार दो सौ तिरासी
MCCLXXXIV	एक हज़ार दो सौ चौरासी
MCCLXXXV	एक हज़ार दो सौ पचासी
MCCLXXXVI	एक हज़ार दो सौ छियासी
MCCLXXXVII	एक हज़ार दो सौ सत्तासी
MCCLXXXVIII	एक हज़ार दो सौ अट्ठासी
MCCLXXXIX	एक हज़ार दो सौ नवासी
MCCXC	एक हज़ार दो सौ नब्बे
MCCXCI	एक हज़ार दो सौ इक्यानबे
MCCXCII	एक हज़ार दो सौ बानबे
MCCXCIII	एक हज़ार दो सौ तिरानबे
MCCXCIV	एक हज़ार दो सौ चौरानबे
MCCXCV	एक हज़ार दो सौ पंचानबे
MCCXCVI	एक हज़ार दो सौ छियानबे
MCCXCVII	एक हज़ार दो सौ सत्तानबे
MCCXCVIII	एक हज़ार दो सौ अट्ठानबे
MCCXCIX	एक हज़ार दो सौ निन्यानबे
MCCC	एक हज़ार तीन सौ
MCCCI	एक हज़ार तीन सौ एक
MCCCII	एक हज़ार तीन सौ दो
MCCCIII	एक हज़ार तीन सौ तीन
MCCCIV	एक हज़ार तीन सौ चार
MCCCV	एक हज़ार तीन सौ पाँच
MCCCVI	एक हज़ार तीन सौ छह
MCCCVII	एक हज़ार तीन सौ सात
MCCCVIII	एक हज़ार तीन सौ आठ
MCCCIX	एक हज़ार तीन सौ नौ
MCCCX	एक हज़ार तीन सौ दस
MCCCXI	एक हज़ार तीन सौ ग्यारह
MCCCXII	एक हज़ार तीन सौ बारह
MCCCXIII	एक हज़ार तीन सौ तेरह
MCCCXIV	एक हज़ार तीन सौ चौदह
MCCCXV	एक हज़ार तीन सौ पंद्रह
MCCCXVI	एक हज़ार तीन सौ सोलह
MCCCXVII	एक हज़ार तीन सौ सत्रह
MCCCXVIII	एक हज़ार तीन सौ अठारह
MCCCXIX	एक हज़ार तीन सौ उन्नीस
MCCCXX	एक हज़ार तीन सौ बीस
MCCCXXI	एक हज़ार तीन सौ इक्कीस
MCCCXXII	एक हज़ार तीन सौ बाईस
MCCCXXIII	एक हज़ार तीन सौ तेईस
MCCCXXIV	एक हज़ार तीन सौ चौबीस
MCCCXXV	एक हज़ार तीन सौ पच्चीस
MCCCXXVI	एक हज़ार तीन सौ छब्बीस
MCCCXXVII	एक हज़ार तीन सौ सत्ताईस
MCCCXXVIII	एक हज़ार तीन सौ अट्ठाईस
MCCCXXIX	एक हज़ार तीन सौ उनतीस
MCCCXXX	एक हज़ार तीन सौ तीस
MCCCXXXI	एक हज़ार तीन सौ इकतीस
MCCCXXXII	एक हज़ार तीन सौ बत्तीस
MCCCXXXIII	एक हज़ार तीन सौ तैंतीस
MCCCXXXIV	एक हज़ार तीन सौ चौंतीस
MCCCXXXV	एक हज़ार तीन सौ पैंतीस
MCCCXXXVI	एक हज़ार तीन सौ छत्तीस
MCCCXXXVII	एक हज़ार तीन सौ सैंतीस
MCCCXXXVIII	एक हज़ार तीन सौ अड़तीस
MCCCXXXIX	एक हज़ार तीन सौ उनतालीस
MCCCXL	एक हज़ार तीन सौ चालीस
MCCCXLI	एक हज़ार तीन सौ इकतालीस
MCCCXLII	एक हज़ार तीन सौ बयालीस
MCCCXLIII	एक हज़ार तीन सौ तैंतालीस
MCCCXLIV	एक हज़ार तीन सौ चौवालीस
MCCCXLV	एक हज़ार तीन सौ पैंतालीस
MCCCXLVI	एक हज़ार तीन सौ छियालीस
MCCCXLVII	एक हज़ार तीन सौ सैंतालीस
MCCCXLVIII	एक हज़ार तीन सौ अड़तालीस
MCCCXLIX	एक हज़ार तीन सौ उनचास
MCCCL	एक हज़ार तीन सौ पचास
MCCCLI	एक हज़ार तीन सौ इक्यावन
MCCCLII	एक हज़ार तीन सौ बावन
MCCCLIII	एक हज़ार तीन सौ तिरेपन
MCCCLIV	एक हज़ार तीन सौ चौवन
MCCCLV	एक हज़ार तीन सौ पचपन
MCCCLVI	एक हज़ार तीन सौ छप्पन
MCCCLVII	एक हज़ार तीन सौ सत्तावन
MCCCLVIII	एक हज़ार तीन सौ अट्ठावन
MCCCLIX	एक हज़ार तीन सौ उनसठ
MCCCLX	एक हज़ार तीन सौ साठ
MCCCLXI	एक हज़ार तीन सौ इकसठ
MCCCLXII	एक हज़ार तीन सौ बासठ
MCCCLXIII	एक हज़ार तीन सौ तिरेसठ
MCCCLXIV	एक हज़ार तीन सौ चौंसठ
MCCCLXV	एक हज़ार तीन सौ पैंसठ
MCCCLXVI	एक हज़ार तीन सौ छियासठ
MCCCLXVII	एक हज़ार तीन सौ सड़सठ
MCCCLXVIII	एक हज़ार तीन सौ अड़सठ
MCCCLXIX	एक हज़ार तीन सौ उनहत्तर
MCCCLXX	एक हज़ार तीन सौ सत्तर
MCCCLXXI	एक हज़ार तीन सौ इकहत्तर
MCCCLXXII	एक हज़ार तीन सौ बहत्तर
MCCCLXXIII	एक हज़ार तीन सौ तिहत्तर
MCCCLXXIV	एक हज़ार तीन सौ चौहत्तर
MCCCLXXV	एक हज़ार तीन सौ पचहत्तर
MCCCLXXVI	एक हज़ार तीन सौ छिहत्तर
MCCCLXXVII	एक हज़ार तीन सौ सतहत्तर
MCCCLXXVIII	एक हज़ार तीन सौ अठहत्तर
MCCCLXXIX	एक हज़ार तीन सौ उनासी
MCCCLXXX	एक हज़ार तीन सौ अस्सी
MCCCLXXXI	एक हज़ार तीन सौ इक्यासी
MCCCLXXXII	एक हज़ार तीन सौ बयासी
MCCCLXXXIII	एक हज़ार तीन सौ तिरासी
MCCCLXXXIV	एक हज़ार तीन सौ चौरासी
MCCCLXXXV	एक हज़ार तीन सौ पचासी
MCCCLXXXVI	एक हज़ार तीन सौ छियासी
MCCCLXXXVII	एक हज़ार तीन सौ सत्तासी
MCCCLXXXVIII	एक हज़ार तीन सौ अट्ठासी
MCCCLXXXIX	एक हज़ार तीन सौ नवासी
MCCCXC	एक हज़ार तीन सौ नब्बे
MCCCXCI	एक हज़ार तीन सौ इक्यानबे
MCCCXCII	एक हज़ार तीन सौ बानबे
MCCCXCIII	एक हज़ार तीन सौ तिरानबे
MCCCXCIV	एक हज़ार तीन सौ चौरानबे
MCCCXCV	एक हज़ार तीन सौ पंचानबे
MCCCXCVI	एक हज़ार तीन सौ छियानबे
MCCCXCVII	एक हज़ार तीन सौ सत्तानबे
MCCCXCVIII	एक हज़ार तीन सौ अट्ठानबे
MCCCXCIX	एक हज़ार तीन सौ निन्यानबे
MCD	एक हज़ार चार सौ
MCDI	एक हज़ार चार सौ एक
MCDII	एक हज़ार चार सौ दो
MCDIII	एक हज़ार चार सौ तीन
MCDIV	एक हज़ार चार सौ चार
MCDV	एक हज़ार चार सौ पाँच
MCDVI	एक हज़ार चार सौ छह
MCDVII	एक हज़ार चार सौ सात
MCDVIII	एक हज़ार चार सौ आठ
MCDIX	एक हज़ार चार सौ नौ
MCDX	एक हज़ार चार सौ दस
MCDXI	एक हज़ार चार सौ ग्यारह
MCDXII	एक हज़ार चार सौ बारह
MCDXIII	एक हज़ार चार सौ तेरह
MCDXIV	एक हज़ार चार सौ चौदह
MCDXV	एक हज़ार चार सौ पंद्रह
MCDXVI	एक हज़ार चार सौ सोलह
MCDXVII	एक हज़ार चार सौ सत्रह
MCDXVIII	एक हज़ार चार सौ अठारह
MCDXIX	एक हज़ार चार सौ उन्नीस
MCDXX	एक हज़ार चार सौ बीस
MCDXXI	एक हज़ार चार सौ इक्कीस
MCDXXII	एक हज़ार चार सौ बाईस
MCDXXIII	एक हज़ार चार सौ तेईस
MCDXXIV	एक हज़ार चार सौ चौबीस
MCDXXV	एक हज़ार चार सौ पच्चीस
MCDXXVI	एक हज़ार चार सौ छब्बीस
MCDXXVII	एक हज़ार चार सौ सत्ताईस
MCDXXVIII	एक हज़ार चार सौ अट्ठाईस
MCDXXIX	एक हज़ार चार सौ उनतीस
MCDXXX	एक हज़ार चार सौ तीस
MCDXXXI	एक हज़ार चार सौ इकतीस
MCDXXXII	एक हज़ार चार सौ बत्तीस
MCDXXXIII	एक हज़ार चार सौ तैंतीस
MCDXXXIV	एक हज़ार चार सौ चौंतीस
MCDXXXV	एक हज़ार चार सौ पैंतीस
MCDXXXVI	एक हज़ार चार सौ छत्तीस
MCDXXXVII	एक हज़ार चार सौ सैंतीस
MCDXXXVIII	एक हज़ार चार सौ अड़तीस
MCDXXXIX	एक हज़ार चार सौ उनतालीस
MCDXL	एक हज़ार चार सौ चालीस
MCDXLI	एक हज़ार चार सौ इकतालीस
MCDXLII	एक हज़ार चार सौ बयालीस
MCDXLIII	एक हज़ार चार सौ तैंतालीस
MCDXLIV	एक हज़ार चार सौ चौवालीस
MCDXLV	एक हज़ार चार सौ पैंतालीस
MCDXLVI	एक हज़ार चार सौ छियालीस
MCDXLVII	एक हज़ार चार सौ सैंतालीस
MCDXLVIII	एक हज़ार चार सौ अड़तालीस
MCDXLIX	एक हज़ार चार सौ उनचास
MCDL	एक हज़ार चार सौ पचास
MCDLI	एक हज़ार चार सौ इक्यावन
MCDLII	एक हज़ार चार सौ बावन
MCDLIII	एक हज़ार चार सौ तिरेपन
MCDLIV	एक हज़ार चार सौ चौवन
MCDLV	एक हज़ार चार सौ पचपन
MCDLVI	एक हज़ार चार सौ छप्पन
MCDLVII	एक हज़ार चार सौ सत्तावन
MCDLVIII	एक हज़ार चार सौ अट्ठावन
MCDLIX	एक हज़ार चार सौ उनसठ
MCDLX	एक हज़ार चार सौ साठ
MCDLXI	एक हज़ार चार सौ इकसठ
MCDLXII	एक हज़ार चार सौ बासठ
MCDLXIII	एक हज़ार चार सौ तिरेसठ
MCDLXIV	एक हज़ार चार सौ चौंसठ
MCDLXV	एक हज़ार चार सौ पैंसठ
MCDLXVI	एक हज़ार चार सौ छियासठ
MCDLXVII	एक हज़ार चार सौ सड़सठ
MCDLXVIII	एक हज़ार चार सौ अड़सठ
MCDLXIX	एक हज़ार चार सौ उनहत्तर
MCDLXX	एक हज़ार चार सौ सत्तर
MCDLXXI	एक हज़ार चार सौ इकहत्तर
MCDLXXII	एक हज़ार चार सौ बहत्तर
MCDLXXIII	एक हज़ार चार सौ तिहत्तर
MCDLXXIV	एक हज़ार चार सौ चौहत्तर
MCDLXXV	एक हज़ार चार सौ पचहत्तर
MCDLXXVI	एक हज़ार चार सौ छिहत्तर
MCDLXXVII	एक हज़ार चार सौ सतहत्तर
MCDLXXVIII	एक हज़ार चार सौ अठहत्तर
MCDLXXIX	एक हज़ार चार सौ उनासी
MCDLXXX	एक हज़ार चार सौ अस्सी
MCDLXXXI	एक हज़ार चार सौ इक्यासी
MCDLXXXII	एक हज़ार चार सौ बयासी
MCDLXXXIII	एक हज़ार चार सौ तिरासी
MCDLXXXIV	एक हज़ार चार सौ चौरासी
MCDLXXXV	एक हज़ार चार सौ पचासी
MCDLXXXVI	एक हज़ार चार सौ छियासी
MCDLXXXVII	एक हज़ार चार सौ सत्तासी
MCDLXXXVIII	एक हज़ार चार सौ अट्ठासी
MCDLXXXIX	एक हज़ार चार सौ नवासी
MCDXC	एक हज़ार चार सौ नब्बे
MCDXCI	एक हज़ार चार सौ इक्यानबे
MCDXCII	एक हज़ार चार सौ बानबे
MCDXCIII	एक हज़ार चार सौ तिरानबे
MCDXCIV	एक हज़ार चार सौ चौरानबे
MCDXCV	एक हज़ार चार सौ पंचानबे
MCDXCVI	एक हज़ार चार सौ छियानबे
MCDXCVII	एक हज़ार चार सौ सत्तानबे
MCDXCVIII	एक हज़ार चार सौ अट्ठानबे
MCDXCIX	एक हज़ार चार सौ निन्यानबे
MD	एक हज़ार पाँच सौ
MDI	एक हज़ार पाँच सौ एक
MDII	एक हज़ार पाँच सौ दो
MDIII	एक हज़ार पाँच सौ तीन
MDIV	एक हज़ार पाँच सौ चार
MDV	एक हज़ार पाँच सौ पाँच
MDVI	एक हज़ार पाँच सौ छह
MDVII	एक हज़ार पाँच सौ सात
MDVIII	एक हज़ार पाँच सौ आठ
MDIX	एक हज़ार पाँच सौ नौ
MDX	एक हज़ार पाँच सौ दस
MDXI	एक हज़ार पाँच सौ ग्यारह
MDXII	एक हज़ार पाँच सौ बारह
MDXIII	एक हज़ार पाँच सौ तेरह
MDXIV	एक हज़ार पाँच सौ चौदह
MDXV	एक हज़ार पाँच सौ पंद्रह
MDXVI	एक हज़ार पाँच सौ सोलह
MDXVII	एक हज़ार पाँच सौ सत्रह
MDXVIII	एक हज़ार पाँच सौ अठारह
MDXIX	एक हज़ार पाँच सौ उन्नीस
MDXX	एक हज़ार पाँच सौ बीस
MDXXI	एक हज़ार पाँच सौ इक्कीस
MDXXII	एक हज़ार पाँच सौ बाईस
MDXXIII	एक हज़ार पाँच सौ तेईस
MDXXIV	एक हज़ार पाँच सौ चौबीस
MDXXV	एक हज़ार पाँच सौ पच्चीस
MDXXVI	एक हज़ार पाँच सौ छब्बीस
MDXXVII	एक हज़ार पाँच सौ सत्ताईस
MDXXVIII	एक हज़ार पाँच सौ अट्ठाईस
MDXXIX	एक हज़ार पाँच सौ उनतीस
MDXXX	एक हज़ार पाँच सौ तीस
MDXXXI	एक हज़ार पाँच सौ इकतीस
MDXXXII	एक हज़ार पाँच सौ बत्तीस
MDXXXIII	एक हज़ार पाँच सौ तैंतीस
MDXXXIV	एक हज़ार पाँच सौ चौंतीस
MDXXXV	एक हज़ार पाँच सौ पैंतीस
MDXXXVI	एक हज़ार पाँच सौ छत्तीस
MDXXXVII	एक हज़ार पाँच सौ सैंतीस
MDXXXVIII	एक हज़ार पाँच सौ अड़तीस
MDXXXIX	एक हज़ार पाँच सौ उनतालीस
MDXL	एक हज़ार पाँच सौ चालीस
MDXLI	एक हज़ार पाँच सौ इकतालीस
MDXLII	एक हज़ार पाँच सौ बयालीस
MDXLIII	एक हज़ार पाँच सौ तैंतालीस
MDXLIV	एक हज़ार पाँच सौ चौवालीस
MDXLV	एक हज़ार पाँच सौ पैंतालीस
MDXLVI	एक हज़ार पाँच सौ छियालीस
MDXLVII	एक हज़ार पाँच सौ सैंतालीस
MDXLVIII	एक हज़ार पाँच सौ अड़तालीस
MDXLIX	एक हज़ार पाँच सौ उनचास
MDL	एक हज़ार पाँच सौ पचास
MDLI	एक हज़ार पाँच सौ इक्यावन
MDLII	एक हज़ार पाँच सौ बावन
MDLIII	एक हज़ार पाँच सौ तिरेपन
MDLIV	एक हज़ार पाँच सौ चौवन
MDLV	एक हज़ार पाँच सौ पचपन
MDLVI	एक हज़ार पाँच सौ छप्पन
MDLVII	एक हज़ार पाँच सौ सत्तावन
MDLVIII	एक हज़ार पाँच सौ अट्ठावन
MDLIX	एक हज़ार पाँच सौ उनसठ
MDLX	एक हज़ार पाँच सौ साठ
MDLXI	एक हज़ार पाँच सौ इकसठ
MDLXII	एक हज़ार पाँच सौ बासठ
MDLXIII	एक हज़ार पाँच सौ तिरेसठ
MDLXIV	एक हज़ार पाँच सौ चौंसठ
MDLXV	एक हज़ार पाँच सौ पैंसठ
MDLXVI	एक हज़ार पाँच सौ छियासठ
MDLXVII	एक हज़ार पाँच सौ सड़सठ
MDLXVIII	एक हज़ार पाँच सौ अड़सठ
MDLXIX	एक हज़ार पाँच सौ उनहत्तर
MDLXX	एक हज़ार पाँच सौ सत्तर
MDLXXI	एक हज़ार पाँच सौ इकहत्तर
MDLXXII	एक हज़ार पाँच सौ बहत्तर
MDLXXIII	एक हज़ार पाँच सौ तिहत्तर
MDLXXIV	एक हज़ार पाँच सौ चौहत्तर
MDLXXV	एक हज़ार पाँच सौ पचहत्तर
MDLXXVI	एक हज़ार पाँच सौ छिहत्तर
MDLXXVII	एक हज़ार पाँच सौ सतहत्तर
MDLXXVIII	एक हज़ार पाँच सौ अठहत्तर
MDLXXIX	एक हज़ार पाँच सौ उनासी
MDLXXX	एक हज़ार पाँच सौ अस्सी
MDLXXXI	एक हज़ार पाँच सौ इक्यासी
MDLXXXII	एक हज़ार पाँच सौ बयासी
MDLXXXIII	एक हज़ार पाँच सौ तिरासी
MDLXXXIV	एक हज़ार पाँच सौ चौरासी
MDLXXXV	एक हज़ार पाँच सौ पचासी
MDLXXXVI	एक हज़ार पाँच सौ छियासी
MDLXXXVII	एक हज़ार पाँच सौ सत्तासी
MDLXXXVIII	एक हज़ार पाँच सौ अट्ठासी
MDLXXXIX	एक हज़ार पाँच सौ नवासी
MDXC	एक हज़ार पाँच सौ नब्बे
MDXCI	एक हज़ार पाँच सौ इक्यानबे
MDXCII	एक हज़ार पाँच सौ बानबे
MDXCIII	एक हज़ार पाँच सौ तिरानबे
MDXCIV	एक हज़ार पाँच सौ चौरानबे
MDXCV	एक हज़ार पाँच सौ पंचानबे
MDXCVI	एक हज़ार पाँच सौ छियानबे
MDXCVII	एक हज़ार पाँच सौ सत्तानबे
MDXCVIII	एक हज़ार पाँच सौ अट्ठानबे
MDXCIX	एक हज़ार पाँच सौ निन्यानबे
MDC	एक हज़ार छह सौ
MDCI	एक हज़ार छह सौ एक
MDCII	एक हज़ार छह सौ दो
MDCIII	एक हज़ार छह सौ तीन
MDCIV	एक हज़ार छह सौ चार
MDCV	एक हज़ार छह सौ पाँच
MDCVI	एक हज़ार छह सौ छह
MDCVII	एक हज़ार छह सौ सात
MDCVIII	एक हज़ार छह सौ आठ
MDCIX	एक हज़ार छह सौ नौ
MDCX	एक हज़ार छह सौ दस
MDCXI	एक हज़ार छह सौ ग्यारह
MDCXII	एक हज़ार छह सौ बारह
MDCXIII	एक हज़ार छह सौ तेरह
MDCXIV	एक हज़ार छह सौ चौदह
MDCXV	एक हज़ार छह सौ पंद्रह
MDCXVI	एक हज़ार छह सौ सोलह
MDCXVII	एक हज़ार छह सौ सत्रह
MDCXVIII	एक हज़ार छह सौ अठारह
MDCXIX	एक हज़ार छह सौ उन्नीस
MDCXX	एक हज़ार छह सौ बीस
MDCXXI	एक हज़ार छह सौ इक्कीस
MDCXXII	एक हज़ार छह सौ बाईस
MDCXXIII	एक हज़ार छह सौ तेईस
MDCXXIV	एक हज़ार छह सौ चौबीस
MDCXXV	एक हज़ार छह सौ पच्चीस
MDCXXVI	एक हज़ार छह सौ छब्बीस
MDCXXVII	एक हज़ार छह सौ सत्ताईस
MDCXXVIII	एक हज़ार छह सौ अट्ठाईस
MDCXXIX	एक हज़ार छह सौ उनतीस
MDCXXX	एक हज़ार छह सौ तीस
MDCXXXI	एक हज़ार छह सौ इकतीस
MDCXXXII	एक हज़ार छह सौ बत्तीस
MDCXXXIII	एक हज़ार छह सौ तैंतीस
MDCXXXIV	एक हज़ार छह सौ चौंतीस
MDCXXXV	एक हज़ार छह सौ पैंतीस
MDCXXXVI	एक हज़ार छह सौ छत्तीस
MDCXXXVII	एक हज़ार छह सौ सैंतीस
MDCXXXVIII	एक हज़ार छह सौ अड़तीस
MDCXXXIX	एक हज़ार छह सौ उनतालीस
MDCXL	एक हज़ार छह सौ चालीस
MDCXLI	एक हज़ार छह सौ इकतालीस
MDCXLII	एक हज़ार छह सौ बयालीस
MDCXLIII	एक हज़ार छह सौ तैंतालीस
MDCXLIV	एक हज़ार छह सौ चौवालीस
MDCXLV	एक हज़ार छह सौ पैंतालीस
MDCXLVI	एक हज़ार छह सौ छियालीस
MDCXLVII	एक हज़ार छह सौ सैंतालीस
MDCXLVIII	एक हज़ार छह सौ अड़तालीस
MDCXLIX	एक हज़ार छह सौ उनचास
MDCL	एक हज़ार छह सौ पचास
MDCLI	एक हज़ार छह सौ इक्यावन
MDCLII	एक हज़ार छह सौ बावन
MDCLIII	एक हज़ार छह सौ तिरेपन
MDCLIV	एक हज़ार छह सौ चौवन
MDCLV	एक हज़ार छह सौ पचपन
MDCLVI	एक हज़ार छह सौ छप्पन
MDCLVII	एक हज़ार छह सौ सत्तावन
MDCLVIII	एक हज़ार छह सौ अट्ठावन
MDCLIX	एक हज़ार छह सौ उनसठ
MDCLX	एक हज़ार छह सौ साठ
MDCLXI	एक हज़ार छह सौ इकसठ
MDCLXII	एक हज़ार छह सौ बासठ
MDCLXIII	एक हज़ार छह सौ तिरेसठ
MDCLXIV	एक हज़ार छह सौ चौंसठ
MDCLXV	एक हज़ार छह सौ पैंसठ
MDCLXVI	एक हज़ार छह सौ छियासठ
MDCLXVII	एक हज़ार छह सौ सड़सठ
MDCLXVIII	एक हज़ार छह सौ अड़सठ
MDCLXIX	एक हज़ार छह सौ उनहत्तर
MDCLXX	एक हज़ार छह सौ सत्तर
MDCLXXI	एक हज़ार छह सौ इकहत्तर
MDCLXXII	एक हज़ार छह सौ बहत्तर
MDCLXXIII	एक हज़ार छह सौ तिहत्तर
MDCLXXIV	एक हज़ार छह सौ चौहत्तर
MDCLXXV	एक हज़ार छह सौ पचहत्तर
MDCLXXVI	एक हज़ार छह सौ छिहत्तर
MDCLXXVII	एक हज़ार छह सौ सतहत्तर
MDCLXXVIII	एक हज़ार छह सौ अठहत्तर
MDCLXXIX	एक हज़ार छह सौ उनासी
MDCLXXX	एक हज़ार छह सौ अस्सी
MDCLXXXI	एक हज़ार छह सौ इक्यासी
MDCLXXXII	एक हज़ार छह सौ बयासी
MDCLXXXIII	एक हज़ार छह सौ तिरासी
MDCLXXXIV	एक हज़ार छह सौ चौरासी
MDCLXXXV	एक हज़ार छह सौ पचासी
MDCLXXXVI	एक हज़ार छह सौ छियासी
MDCLXXXVII	एक हज़ार छह सौ सत्तासी
MDCLXXXVIII	एक हज़ार छह सौ अट्ठासी
MDCLXXXIX	एक हज़ार छह सौ नवासी
MDCXC	एक हज़ार छह सौ नब्बे
MDCXCI	एक हज़ार छह सौ इक्यानबे
MDCXCII	एक हज़ार छह सौ बानबे
MDCXCIII	एक हज़ार छह सौ तिरानबे
MDCXCIV	एक हज़ार छह सौ चौरानबे
MDCXCV	एक हज़ार छह सौ पंचानबे
MDCXCVI	एक हज़ार छह सौ छियानबे
MDCXCVII	एक हज़ार छह सौ सत्तानबे
MDCXCVIII	एक हज़ार छह सौ अट्ठानबे
MDCXCIX	एक हज़ार छह सौ निन्यानबे
MDCC	एक हज़ार सात सौ
MDCCI	एक हज़ार सात सौ एक
MDCCII	एक हज़ार सात सौ दो
MDCCIII	एक हज़ार सात सौ तीन
MDCCIV	एक हज़ार सात सौ चार
MDCCV	एक हज़ार सात सौ पाँच
MDCCVI	एक हज़ार सात सौ छह
MDCCVII	एक हज़ार सात सौ सात
MDCCVIII	एक हज़ार सात सौ आठ
MDCCIX	एक हज़ार सात सौ नौ
MDCCX	एक हज़ार सात सौ दस
MDCCXI	एक हज़ार सात सौ ग्यारह
MDCCXII	एक हज़ार सात सौ बारह
MDCCXIII	एक हज़ार सात सौ तेरह
MDCCXIV	एक हज़ार सात सौ चौदह
MDCCXV	एक हज़ार सात सौ पंद्रह
MDCCXVI	एक हज़ार सात सौ सोलह
MDCCXVII	एक हज़ार सात सौ सत्रह
MDCCXVIII	एक हज़ार सात सौ अठारह
MDCCXIX	एक हज़ार सात सौ उन्नीस
MDCCXX	एक हज़ार सात सौ बीस
MDCCXXI	एक हज़ार सात सौ इक्कीस
MDCCXXII	एक हज़ार सात सौ बाईस
MDCCXXIII	एक हज़ार सात सौ तेईस
MDCCXXIV	एक हज़ार सात सौ चौबीस
MDCCXXV	एक हज़ार सात सौ पच्चीस
MDCCXXVI	एक हज़ार सात सौ छब्बीस
MDCCXXVII	एक हज़ार सात सौ सत्ताईस
MDCCXXVIII	एक हज़ार सात सौ अट्ठाईस
MDCCXXIX	एक हज़ार सात सौ उनतीस
MDCCXXX	एक हज़ार सात सौ तीस
MDCCXXXI	एक हज़ार सात सौ इकतीस
MDCCXXXII	एक हज़ार सात सौ बत्तीस
MDCCXXXIII	एक हज़ार सात सौ तैंतीस
MDCCXXXIV	एक हज़ार सात सौ चौंतीस
MDCCXXXV	एक हज़ार सात सौ पैंतीस
MDCCXXXVI	एक हज़ार सात सौ छत्तीस
MDCCXXXVII	एक हज़ार सात सौ सैंतीस
MDCCXXXVIII	एक हज़ार सात सौ अड़तीस
MDCCXXXIX	एक हज़ार सात सौ उनतालीस
MDCCXL	एक हज़ार सात सौ चालीस
MDCCXLI	एक हज़ार सात सौ इकतालीस
MDCCXLII	एक हज़ार सात सौ बयालीस
MDCCXLIII	एक हज़ार सात सौ तैंतालीस
MDCCXLIV	एक हज़ार सात सौ चौवालीस
MDCCXLV	एक हज़ार सात सौ पैंतालीस
MDCCXLVI	एक हज़ार सात सौ छियालीस
MDCCXLVII	एक हज़ार सात सौ सैंतालीस
MDCCXLVIII	एक हज़ार सात सौ अड़तालीस
MDCCXLIX	एक हज़ार सात सौ उनचास
MDCCL	एक हज़ार सात सौ पचास
MDCCLI	एक हज़ार सात सौ इक्यावन
MDCCLII	एक हज़ार सात सौ बावन
MDCCLIII	एक हज़ार सात सौ तिरेपन
MDCCLIV	एक हज़ार सात सौ चौवन
MDCCLV	एक हज़ार सात सौ पचपन
MDCCLVI	एक हज़ार सात सौ छप्पन
MDCCLVII	एक हज़ार सात सौ सत्तावन
MDCCLVIII	एक हज़ार सात सौ अट्ठावन
MDCCLIX	एक हज़ार सात सौ उनसठ
MDCCLX	एक हज़ार सात सौ साठ
MDCCLXI	एक हज़ार सात सौ इकसठ
MDCCLXII	एक हज़ार सात सौ बासठ
MDCCLXIII	एक हज़ार सात सौ तिरेसठ
MDCCLXIV	एक हज़ार सात सौ चौंसठ
MDCCLXV	एक हज़ार सात सौ पैंसठ
MDCCLXVI	एक हज़ार सात सौ छियासठ
MDCCLXVII	एक हज़ार सात सौ सड़सठ
MDCCLXVIII	एक हज़ार सात सौ अड़सठ
MDCCLXIX	एक हज़ार सात सौ उनहत्तर
MDCCLXX	एक हज़ार सात सौ सत्तर
MDCCLXXI	एक हज़ार सात सौ इकहत्तर
MDCCLXXII	एक हज़ार सात सौ बहत्तर
MDCCLXXIII	एक हज़ार सात सौ तिहत्तर
MDCCLXXIV	एक हज़ार सात सौ चौहत्तर
MDCCLXXV	एक हज़ार सात सौ पचहत्तर
MDCCLXXVI	एक हज़ार सात सौ छिहत्तर
MDCCLXXVII	एक हज़ार सात सौ सतहत्तर
MDCCLXXVIII	एक हज़ार सात सौ अठहत्तर
MDCCLXXIX	एक हज़ार सात सौ उनासी
MDCCLXXX	एक हज़ार सात सौ अस्सी
MDCCLXXXI	एक हज़ार सात सौ इक्यासी
MDCCLXXXII	एक हज़ार सात सौ बयासी
MDCCLXXXIII	एक हज़ार सात सौ तिरासी
MDCCLXXXIV	एक हज़ार सात सौ चौरासी
MDCCLXXXV	एक हज़ार सात सौ पचासी
MDCCLXXXVI	एक हज़ार सात सौ छियासी
MDCCLXXXVII	एक हज़ार सात सौ सत्तासी
MDCCLXXXVIII	एक हज़ार सात सौ अट्ठासी
MDCCLXXXIX	एक हज़ार सात सौ नवासी
MDCCXC	एक हज़ार सात सौ नब्बे
MDCCXCI	एक हज़ार सात सौ इक्यानबे
MDCCXCII	एक हज़ार सात सौ बानबे
MDCCXCIII	एक हज़ार सात सौ तिरानबे
MDCCXCIV	एक हज़ार सात सौ चौरानबे
MDCCXCV	एक हज़ार सात सौ पंचानबे
MDCCXCVI	एक हज़ार सात सौ छियानबे
MDCCXCVII	एक हज़ार सात सौ सत्तानबे
MDCCXCVIII	एक हज़ार सात सौ अट्ठानबे
MDCCXCIX	एक हज़ार सात सौ निन्यानबे
MDCCC	एक हज़ार आठ सौ
MDCCCI	एक हज़ार आठ सौ एक
MDCCCII	एक हज़ार आठ सौ दो
MDCCCIII	एक हज़ार आठ सौ तीन
MDCCCIV	एक हज़ार आठ सौ चार
MDCCCV	एक हज़ार आठ सौ पाँच
MDCCCVI	एक हज़ार आठ सौ छह
MDCCCVII	एक हज़ार आठ सौ सात
MDCCCVIII	एक हज़ार आठ सौ आठ
MDCCCIX	एक हज़ार आठ सौ नौ
MDCCCX	एक हज़ार आठ सौ दस
MDCCCXI	एक हज़ार आठ सौ ग्यारह
MDCCCXII	एक हज़ार आठ सौ बारह
MDCCCXIII	एक हज़ार आठ सौ तेरह
MDCCCXIV	एक हज़ार आठ सौ चौदह
MDCCCXV	एक हज़ार आठ सौ पंद्रह
MDCCCXVI	एक हज़ार आठ सौ सोलह
MDCCCXVII	एक हज़ार आठ सौ सत्रह
MDCCCXVIII	एक हज़ार आठ सौ अठारह
MDCCCXIX	एक हज़ार आठ सौ उन्नीस
MDCCCXX	एक हज़ार आठ सौ बीस
MDCCCXXI	एक हज़ार आठ सौ इक्कीस
MDCCCXXII	एक हज़ार आठ सौ बाईस
MDCCCXXIII	एक हज़ार आठ सौ तेईस
MDCCCXXIV	एक हज़ार आठ सौ चौबीस
MDCCCXXV	एक हज़ार आठ सौ पच्चीस
MDCCCXXVI	एक हज़ार आठ सौ छब्बीस
MDCCCXXVII	एक हज़ार आठ सौ सत्ताईस
MDCCCXXVIII	एक हज़ार आठ सौ अट्ठाईस
MDCCCXXIX	एक हज़ार आठ सौ उनतीस
MDCCCXXX	एक हज़ार आठ सौ तीस
MDCCCXXXI	एक हज़ार आठ सौ इकतीस
MDCCCXXXII	एक हज़ार आठ सौ बत्तीस
MDCCCXXXIII	एक हज़ार आठ सौ तैंतीस
MDCCCXXXIV	एक हज़ार आठ सौ चौंतीस
MDCCCXXXV	एक हज़ार आठ सौ पैंतीस
MDCCCXXXVI	एक हज़ार आठ सौ छत्तीस
MDCCCXXXVII	एक हज़ार आठ सौ सैंतीस
MDCCCXXXVIII	एक हज़ार आठ सौ अड़तीस
MDCCCXXXIX	एक हज़ार आठ सौ उनतालीस
MDCCCXL	एक हज़ार आठ सौ चालीस
MDCCCXLI	एक हज़ार आठ सौ इकतालीस
MDCCCXLII	एक हज़ार आठ सौ बयालीस
MDCCCXLIII	एक हज़ार आठ सौ तैंतालीस
MDCCCXLIV	एक हज़ार आठ सौ चौवालीस
MDCCCXLV	एक हज़ार आठ सौ पैंतालीस
MDCCCXLVI	एक हज़ार आठ सौ छियालीस
MDCCCXLVII	एक हज़ार आठ सौ सैंतालीस
MDCCCXLVIII	एक हज़ार आठ सौ अड़तालीस
MDCCCXLIX	एक हज़ार आठ सौ उनचास
MDCCCL	एक हज़ार आठ सौ पचास
MDCCCLI	एक हज़ार आठ सौ इक्यावन
MDCCCLII	एक हज़ार आठ सौ बावन
MDCCCLIII	एक हज़ार आठ सौ तिरेपन
MDCCCLIV	एक हज़ार आठ सौ चौवन
MDCCCLV	एक हज़ार आठ सौ पचपन
MDCCCLVI	एक हज़ार आठ सौ छप्पन
MDCCCLVII	एक हज़ार आठ सौ सत्तावन
MDCCCLVIII	एक हज़ार आठ सौ अट्ठावन
MDCCCLIX	एक हज़ार आठ सौ उनसठ
MDCCCLX	एक हज़ार आठ सौ साठ
MDCCCLXI	एक हज़ार आठ सौ इकसठ
MDCCCLXII	एक हज़ार आठ सौ बासठ
MDCCCLXIII	एक हज़ार आठ सौ तिरेसठ
MDCCCLXIV	एक हज़ार आठ सौ चौंसठ
MDCCCLXV	एक हज़ार आठ सौ पैंसठ
MDCCCLXVI	एक हज़ार आठ सौ छियासठ
MDCCCLXVII	एक हज़ार आठ सौ सड़सठ
MDCCCLXVIII	एक हज़ार आठ सौ अड़सठ
MDCCCLXIX	एक हज़ार आठ सौ उनहत्तर
MDCCCLXX	एक हज़ार आठ सौ सत्तर
MDCCCLXXI	एक हज़ार आठ सौ इकहत्तर
MDCCCLXXII	एक हज़ार आठ सौ बहत्तर
MDCCCLXXIII	एक हज़ार आठ सौ तिहत्तर
MDCCCLXXIV	एक हज़ार आठ सौ चौहत्तर
MDCCCLXXV	एक हज़ार आठ सौ पचहत्तर
MDCCCLXXVI	एक हज़ार आठ सौ छिहत्तर
MDCCCLXXVII	एक हज़ार आठ सौ सतहत्तर
MDCCCLXXVIII	एक हज़ार आठ सौ अठहत्तर
MDCCCLXXIX	एक हज़ार आठ सौ उनासी
MDCCCLXXX	एक हज़ार आठ सौ अस्सी
MDCCCLXXXI	एक हज़ार आठ सौ इक्यासी
MDCCCLXXXII	एक हज़ार आठ सौ बयासी
MDCCCLXXXIII	एक हज़ार आठ सौ तिरासी
MDCCCLXXXIV	एक हज़ार आठ सौ चौरासी
MDCCCLXXXV	एक हज़ार आठ सौ पचासी
MDCCCLXXXVI	एक हज़ार आठ सौ छियासी
MDCCCLXXXVII	एक हज़ार आठ सौ सत्तासी
MDCCCLXXXVIII	एक हज़ार आठ सौ अट्ठासी
MDCCCLXXXIX	एक हज़ार आठ सौ नवासी
MDCCCXC	एक हज़ार आठ सौ नब्बे
MDCCCXCI	एक हज़ार आठ सौ इक्यानबे
MDCCCXCII	एक हज़ार आठ सौ बानबे
MDCCCXCIII	एक हज़ार आठ सौ तिरानबे
MDCCCXCIV	एक हज़ार आठ सौ चौरानबे
MDCCCXCV	एक हज़ार आठ सौ पंचानबे
MDCCCXCVI	एक हज़ार आठ सौ छियानबे
MDCCCXCVII	एक हज़ार आठ सौ सत्तानबे
MDCCCXCVIII	एक हज़ार आठ सौ अट्ठानबे
MDCCCXCIX	एक हज़ार आठ सौ निन्यानबे
MCM	एक हज़ार नौ सौ
MCMI	एक हज़ार नौ सौ एक
MCMII	एक हज़ार नौ सौ दो
MCMIII	एक हज़ार नौ सौ तीन
MCMIV	एक हज़ार नौ सौ चार
MCMV	एक हज़ार नौ सौ पाँच
MCMVI	एक हज़ार नौ सौ छह
MCMVII	एक हज़ार नौ सौ सात
MCMVIII	एक हज़ार नौ सौ आठ
MCMIX	एक हज़ार नौ सौ नौ
MCMX	एक हज़ार नौ सौ दस
MCMXI	एक हज़ार नौ सौ ग्यारह
MCMXII	एक हज़ार नौ सौ बारह
MCMXIII	एक हज़ार नौ सौ तेरह
MCMXIV	एक हज़ार नौ सौ चौदह
MCMXV	एक हज़ार नौ सौ पंद्रह
MCMXVI	एक हज़ार नौ सौ सोलह
MCMXVII	एक हज़ार नौ सौ सत्रह
MCMXVIII	एक हज़ार नौ सौ अठारह
MCMXIX	एक हज़ार नौ सौ उन्नीस
MCMXX	एक हज़ार नौ सौ बीस
MCMXXI	एक हज़ार नौ सौ इक्कीस
MCMXXII	एक हज़ार नौ सौ बाईस
MCMXXIII	एक हज़ार नौ सौ तेईस
MCMXXIV	एक हज़ार नौ सौ चौबीस
MCMXXV	एक हज़ार नौ सौ पच्चीस
MCMXXVI	एक हज़ार नौ सौ छब्बीस
MCMXXVII	एक हज़ार नौ सौ सत्ताईस
MCMXXVIII	एक हज़ार नौ सौ अट्ठाईस
MCMXXIX	एक हज़ार नौ सौ उनतीस
MCMXXX	एक हज़ार नौ सौ तीस
MCMXXXI	एक हज़ार नौ सौ इकतीस
MCMXXXII	एक हज़ार नौ सौ बत्तीस
MCMXXXIII	एक हज़ार नौ सौ तैंतीस
MCMXXXIV	एक हज़ार नौ सौ चौंतीस
MCMXXXV	एक हज़ार नौ सौ पैंतीस
MCMXXXVI	एक हज़ार नौ सौ छत्तीस
MCMXXXVII	एक हज़ार नौ सौ सैंतीस
MCMXXXVIII	एक हज़ार नौ सौ अड़तीस
MCMXXXIX	एक हज़ार नौ सौ उनतालीस
MCMXL	एक हज़ार नौ सौ चालीस
MCMXLI	एक हज़ार नौ सौ इकतालीस
MCMXLII	एक हज़ार नौ सौ बयालीस
MCMXLIII	एक हज़ार नौ सौ तैंतालीस
MCMXLIV	एक हज़ार नौ सौ चौवालीस
MCMXLV	एक हज़ार नौ सौ पैंतालीस
MCMXLVI	एक हज़ार नौ सौ छियालीस
MCMXLVII	एक हज़ार नौ सौ सैंतालीस
MCMXLVIII	एक हज़ार नौ सौ अड़तालीस
MCMXLIX	एक हज़ार नौ सौ उनचास
MCML	एक हज़ार नौ सौ पचास
MCMLI	एक हज़ार नौ सौ इक्यावन
MCMLII	एक हज़ार नौ सौ बावन
MCMLIII	एक हज़ार नौ सौ तिरेपन
MCMLIV	एक हज़ार नौ सौ चौवन
MCMLV	एक हज़ार नौ सौ पचपन
MCMLVI	एक हज़ार नौ सौ छप्पन
MCMLVII	एक हज़ार नौ सौ सत्तावन
MCMLVIII	एक हज़ार नौ सौ अट्ठावन
MCMLIX	एक हज़ार नौ सौ उनसठ
MCMLX	एक हज़ार नौ सौ साठ
MCMLXI	एक हज़ार नौ सौ इकसठ
MCMLXII	एक हज़ार नौ सौ बासठ
MCMLXIII	एक हज़ार नौ सौ तिरेसठ
MCMLXIV	एक हज़ार नौ सौ चौंसठ
MCMLXV	एक हज़ार नौ सौ पैंसठ
MCMLXVI	एक हज़ार नौ सौ छियासठ
MCMLXVII	एक हज़ार नौ सौ सड़सठ
MCMLXVIII	एक हज़ार नौ सौ अड़सठ
MCMLXIX	एक हज़ार नौ सौ उनहत्तर
MCMLXX	एक हज़ार नौ सौ सत्तर
MCMLXXI	एक हज़ार नौ सौ इकहत्तर
MCMLXXII	एक हज़ार नौ सौ बहत्तर
MCMLXXIII	एक हज़ार नौ सौ तिहत्तर
MCMLXXIV	एक हज़ार नौ सौ चौहत्तर
MCMLXXV	एक हज़ार नौ सौ पचहत्तर
MCMLXXVI	एक हज़ार नौ सौ छिहत्तर
MCMLXXVII	एक हज़ार नौ सौ सतहत्तर
MCMLXXVIII	एक हज़ार नौ सौ अठहत्तर
MCMLXXIX	एक हज़ार नौ सौ उनासी
MCMLXXX	एक हज़ार नौ सौ अस्सी
MCMLXXXI	एक हज़ार नौ सौ इक्यासी
MCMLXXXII	एक हज़ार नौ सौ बयासी
MCMLXXXIII	एक हज़ार नौ सौ तिरासी
MCMLXXXIV	एक हज़ार नौ सौ चौरासी
MCMLXXXV	एक हज़ार नौ सौ पचासी
MCMLXXXVI	एक हज़ार नौ सौ छियासी
MCMLXXXVII	एक हज़ार नौ सौ सत्तासी
MCMLXXXVIII	एक हज़ार नौ सौ अट्ठासी
MCMLXXXIX	एक हज़ार नौ सौ नवासी
MCMXC	एक हज़ार नौ सौ नब्बे
MCMXCI	एक हज़ार नौ सौ इक्यानबे
MCMXCII	एक हज़ार नौ सौ बानबे
MCMXCIII	एक हज़ार नौ सौ तिरानबे
MCMXCIV	एक हज़ार नौ सौ चौरानबे
MCMXCV	एक हज़ार नौ सौ पंचानबे
MCMXCVI	एक हज़ार नौ सौ छियानबे
MCMXCVII	एक हज़ार नौ सौ सत्तानबे
MCMXCVIII	एक हज़ार नौ सौ अट्ठानबे
MCMXCIX	एक हज़ार नौ सौ निन्यानबे
MM	दो हज़ार
