I	ਇੱਕ
II	ਦੋ
III	ਤਿੰਨ
IV	ਚਾਰ
V	ਪੰਜ
VI	ਛੇ
VII	ਸੱਤ
VIII	ਅੱਠ
IX	ਨੌਂ
X	ਦਸ
XI	ਗਿਆਰਾਂ
XII	ਬਾਰਾਂ
XIII	ਤੇਰਾਂ
XIV	ਚੌਦਾਂ
XV	ਪੰਦਰਾਂ
XVI	ਸੋਲਾਂ
XVII	ਸਤਾਰਾਂ
XVIII	ਅਠਾਰਾਂ
XIX	ਉੱਨੀ
XX	ਵੀਹ
XXI	ਇੱਕੀ
XXII	ਬਾਈ
XXIII	ਤੇਈ
XXIV	ਚੌਬੀ
XXV	ਪੱਚੀ
XXVI	ਛੱਬੀ
XXVII	ਸਤਾਈ
XXVIII	ਅਠਾਈ
XXIX	ਉਨੱਤੀ
XXX	ਤੀਹ
XXXI	ਇਕੱਤੀ
XXXII	ਬੱਤੀ
XXXIII	ਤੇਤੀ
XXXIV	ਚੌਂਤੀ
XXXV	ਪੈਂਤੀ
XXXVI	ਛੱਤੀ
XXXVII	ਸੈਂਤੀ
XXXVIII	ਅੜਤੀ
XXXIX	ਉਨਤਾਲੀ
XL	ਚਾਲੀ
XLI	ਇਕਤਾਲੀ
XLII	ਬਿਆਲੀ
XLIII	ਤਰਤਾਲੀ
XLIV	ਚਵਾਲੀ
XLV	ਪੈਂਤਾਲੀ
XLVI	ਛਿਆਲੀ
XLVII	ਸੈਂਤਾਲੀ
XLVIII	ਅੜਤਾਲੀ
XLIX	ਉਨੰਜਾ
L	ਪੰਜਾਹ
LI	ਇਕਵੰਜਾ
LII	ਬਵੰਜਾ
LIII	ਤਰਵੰਜਾ
LIV	ਚੁਰੰਜਾ
LV	ਪਚਵੰਜਾ
LVI	ਛਪੰਜਾ
LVII	ਸਤਵੰਜਾ
LVIII	ਅਠਵੰਜਾ
LIX	ਉਨੱਠ
LX	ਸੱਠ
LXI	ਇਕਠ
LXII	ਬਾਠ
LXIII	ਤਰੇਠ
LXIV	ਚੌਂਠ
LXV	ਪੈਂਠ
LXVI	ਛਿਆਠ
LXVII	ਸਤੱਠ
LXVIII	ਅਠੱਠ
LXIX	ਉਨੱਤਰ
LXX	ਸੱਤਰ
LXXI	ਇਕੱਤਰ
LXXII	ਬਹੱਤਰ
LXXIII	ਤਿਹੱਤਰ
LXXIV	ਚੁਹੱਤਰ
LXXV	ਪੰਝੱਤਰ
LXXVI	ਛਿਹੱਤਰ
LXXVII	ਸਤੱਤਰ
LXXVIII	ਅਠੱਤਰ
LXXIX	ਉਨਾਸੀ
LXXX	ਅੱਸੀ
LXXXI	ਇਕਾਸੀ
LXXXII	ਬਿਆਸੀ
LXXXIII	ਤਿਰਾਸੀ
LXXXIV	ਚੁਰਾਸੀ
LXXXV	ਪਚਾਸੀ
LXXXVI	ਛਿਆਸੀ
LXXXVII	ਸਤਾਸੀ
LXXXVIII	ਅਠਾਸੀ
LXXXIX	ਨਵਾਸੀ
XC	ਨੱਬੇ
XCI	ਇਕਾਨਵੇਂ
XCII	ਬਾਨਵੇਂ
XCIII	ਤਰਾਨਵੇਂ
XCIV	ਚੁਰਾਨਵੇਂ
XCV	ਪਚਾਨਵੇਂ
XCVI	ਛਿਆਨਵੇਂ
XCVII	ਸਤਾਨਵੇਂ
XCVIII	ਅਠਾਨਵੇਂ
XCIX	ਨਿਨਾਨਵੇਂ
C	ਇੱਕ ਸੌ
CI	ਇੱਕ ਸੌ ਇੱਕ
CII	ਇੱਕ ਸੌ ਦੋ
CIII	ਇੱਕ ਸੌ ਤਿੰਨ
CIV	ਇੱਕ ਸੌ ਚਾਰ
CV	ਇੱਕ ਸੌ ਪੰਜ
CVI	ਇੱਕ ਸੌ ਛੇ
CVII	ਇੱਕ ਸੌ ਸੱਤ
CVIII	ਇੱਕ ਸੌ ਅੱਠ
CIX	ਇੱਕ ਸੌ ਨੌਂ
CX	ਇੱਕ ਸੌ ਦਸ
CXI	ਇੱਕ ਸੌ ਗਿਆਰਾਂ
CXII	ਇੱਕ ਸੌ ਬਾਰਾਂ
CXIII	ਇੱਕ ਸੌ ਤੇਰਾਂ
CXIV	ਇੱਕ ਸੌ ਚੌਦਾਂ
CXV	ਇੱਕ ਸੌ ਪੰਦਰਾਂ
CXVI	ਇੱਕ ਸੌ ਸੋਲਾਂ
CXVII	ਇੱਕ ਸੌ ਸਤਾਰਾਂ
CXVIII	ਇੱਕ ਸੌ ਅਠਾਰਾਂ
CXIX	ਇੱਕ ਸੌ ਉੱਨੀ
CXX	ਇੱਕ ਸੌ ਵੀਹ
CXXI	ਇੱਕ ਸੌ ਇੱਕੀ
CXXII	ਇੱਕ ਸੌ ਬਾਈ
CXXIII	ਇੱਕ ਸੌ ਤੇਈ
CXXIV	ਇੱਕ ਸੌ ਚੌਬੀ
CXXV	ਇੱਕ ਸੌ ਪੱਚੀ
CXXVI	ਇੱਕ ਸੌ ਛੱਬੀ
CXXVII	ਇੱਕ ਸੌ ਸਤਾਈ
CXXVIII	ਇੱਕ ਸੌ ਅਠਾਈ
CXXIX	ਇੱਕ ਸੌ ਉਨੱਤੀ
CXXX	ਇੱਕ ਸੌ ਤੀਹ
CXXXI	ਇੱਕ ਸੌ ਇਕੱਤੀ
CXXXII	ਇੱਕ ਸੌ ਬੱਤੀ
CXXXIII	ਇੱਕ ਸੌ ਤੇਤੀ
CXXXIV	ਇੱਕ ਸੌ ਚੌਂਤੀ
CXXXV	ਇੱਕ ਸੌ ਪੈਂਤੀ
CXXXVI	ਇੱਕ ਸੌ ਛੱਤੀ
CXXXVII	ਇੱਕ ਸੌ ਸੈਂਤੀ
CXXXVIII	ਇੱਕ ਸੌ ਅੜਤੀ
CXXXIX	ਇੱਕ ਸੌ ਉਨਤਾਲੀ
CXL	ਇੱਕ ਸੌ ਚਾਲੀ
CXLI	ਇੱਕ ਸੌ ਇਕਤਾਲੀ
CXLII	ਇੱਕ ਸੌ ਬਿਆਲੀ
CXLIII	ਇੱਕ ਸੌ ਤਰਤਾਲੀ
CXLIV	ਇੱਕ ਸੌ ਚਵਾਲੀ
CXLV	ਇੱਕ ਸੌ ਪੈਂਤਾਲੀ
CXLVI	ਇੱਕ ਸੌ ਛਿਆਲੀ
CXLVII	ਇੱਕ ਸੌ ਸੈਂਤਾਲੀ
CXLVIII	ਇੱਕ ਸੌ ਅੜਤਾਲੀ
CXLIX	ਇੱਕ ਸੌ ਉਨੰਜਾ
CL	ਇੱਕ ਸੌ ਪੰਜਾਹ
CLI	ਇੱਕ ਸੌ ਇਕਵੰਜਾ
CLII	ਇੱਕ ਸੌ ਬਵੰਜਾ
CLIII	ਇੱਕ ਸੌ ਤਰਵੰਜਾ
CLIV	ਇੱਕ ਸੌ ਚੁਰੰਜਾ
CLV	ਇੱਕ ਸੌ ਪਚਵੰਜਾ
CLVI	ਇੱਕ ਸੌ ਛਪੰਜਾ
CLVII	ਇੱਕ ਸੌ ਸਤਵੰਜਾ
CLVIII	ਇੱਕ ਸੌ ਅਠਵੰਜਾ
CLIX	ਇੱਕ ਸੌ ਉਨੱਠ
CLX	ਇੱਕ ਸੌ ਸੱਠ
CLXI	ਇੱਕ ਸੌ ਇਕਠ
CLXII	ਇੱਕ ਸੌ ਬਾਠ
CLXIII	ਇੱਕ ਸੌ ਤਰੇਠ
CLXIV	ਇੱਕ ਸੌ ਚੌਂਠ
CLXV	ਇੱਕ ਸੌ ਪੈਂਠ
CLXVI	ਇੱਕ ਸੌ ਛਿਆਠ
CLXVII	ਇੱਕ ਸੌ ਸਤੱਠ
CLXVIII	ਇੱਕ ਸੌ ਅਠੱਠ
CLXIX	ਇੱਕ ਸੌ ਉਨੱਤਰ
CLXX	ਇੱਕ ਸੌ ਸੱਤਰ
CLXXI	ਇੱਕ ਸੌ ਇਕੱਤਰ
CLXXII	ਇੱਕ ਸੌ ਬਹੱਤਰ
CLXXIII	ਇੱਕ ਸੌ ਤਿਹੱਤਰ
CLXXIV	ਇੱਕ ਸੌ ਚੁਹੱਤਰ
CLXXV	ਇੱਕ ਸੌ ਪੰਝੱਤਰ
CLXXVI	ਇੱਕ ਸੌ ਛਿਹੱਤਰ
CLXXVII	ਇੱਕ ਸੌ ਸਤੱਤਰ
CLXXVIII	ਇੱਕ ਸੌ ਅਠੱਤਰ
CLXXIX	ਇੱਕ ਸੌ ਉਨਾਸੀ
CLXXX	ਇੱਕ ਸੌ ਅੱਸੀ
CLXXXI	ਇੱਕ ਸੌ ਇਕਾਸੀ
CLXXXII	ਇੱਕ ਸੌ ਬਿਆਸੀ
CLXXXIII	ਇੱਕ ਸੌ ਤਿਰਾਸੀ
CLXXXIV	ਇੱਕ ਸੌ ਚੁਰਾਸੀ
CLXXXV	ਇੱਕ ਸੌ ਪਚਾਸੀ
CLXXXVI	ਇੱਕ ਸੌ ਛਿਆਸੀ
CLXXXVII	ਇੱਕ ਸੌ ਸਤਾਸੀ
CLXXXVIII	ਇੱਕ ਸੌ ਅਠਾਸੀ
CLXXXIX	ਇੱਕ ਸੌ ਨਵਾਸੀ
CXC	ਇੱਕ ਸੌ ਨੱਬੇ
CXCI	ਇੱਕ ਸੌ ਇਕਾਨਵੇਂ
CXCII	ਇੱਕ ਸੌ ਬਾਨਵੇਂ
CXCIII	ਇੱਕ ਸੌ ਤਰਾਨਵੇਂ
CXCIV	ਇੱਕ ਸੌ ਚੁਰਾਨਵੇਂ
CXCV	ਇੱਕ ਸੌ ਪਚਾਨਵੇਂ
CXCVI	ਇੱਕ ਸੌ ਛਿਆਨਵੇਂ
CXCVII	ਇੱਕ ਸੌ ਸਤਾਨਵੇਂ
CXCVIII	ਇੱਕ ਸੌ ਅਠਾਨਵੇਂ
CXCIX	ਇੱਕ ਸੌ ਨਿਨਾਨਵੇਂ
CC	ਦੋ ਸੌ
CCI	ਦੋ ਸੌ ਇੱਕ
CCII	ਦੋ ਸੌ ਦੋ
CCIII	ਦੋ ਸੌ ਤਿੰਨ
CCIV	ਦੋ ਸੌ ਚਾਰ
CCV	ਦੋ ਸੌ ਪੰਜ
CCVI	ਦੋ ਸੌ ਛੇ
CCVII	ਦੋ ਸੌ ਸੱਤ
CCVIII	ਦੋ ਸੌ ਅੱਠ
CCIX	ਦੋ ਸੌ ਨੌਂ
CCX	ਦੋ ਸੌ ਦਸ
CCXI	ਦੋ ਸੌ ਗਿਆਰਾਂ
CCXII	ਦੋ ਸੌ ਬਾਰਾਂ
CCXIII	ਦੋ ਸੌ ਤੇਰਾਂ
CCXIV	ਦੋ ਸੌ ਚੌਦਾਂ
CCXV	ਦੋ ਸੌ ਪੰਦਰਾਂ
CCXVI	ਦੋ ਸੌ ਸੋਲਾਂ
CCXVII	ਦੋ ਸੌ ਸਤਾਰਾਂ
CCXVIII	ਦੋ ਸੌ ਅਠਾਰਾਂ
CCXIX	ਦੋ ਸੌ ਉੱਨੀ
CCXX	ਦੋ ਸੌ ਵੀਹ
CCXXI	ਦੋ ਸੌ ਇੱਕੀ
CCXXII	ਦੋ ਸੌ ਬਾਈ
CCXXIII	ਦੋ ਸੌ ਤੇਈ
CCXXIV	ਦੋ ਸੌ ਚੌਬੀ
CCXXV	ਦੋ ਸੌ ਪੱਚੀ
CCXXVI	ਦੋ ਸੌ ਛੱਬੀ
CCXXVII	ਦੋ ਸੌ ਸਤਾਈ
CCXXVIII	ਦੋ ਸੌ ਅਠਾਈ
CCXXIX	ਦੋ ਸੌ ਉਨੱਤੀ
CCXXX	ਦੋ ਸੌ ਤੀਹ
CCXXXI	ਦੋ ਸੌ ਇਕੱਤੀ
CCXXXII	ਦੋ ਸੌ ਬੱਤੀ
CCXXXIII	ਦੋ ਸੌ ਤੇਤੀ
CCXXXIV	ਦੋ ਸੌ ਚੌਂਤੀ
CCXXXV	ਦੋ ਸੌ ਪੈਂਤੀ
CCXXXVI	ਦੋ ਸੌ ਛੱਤੀ
CCXXXVII	ਦੋ ਸੌ ਸੈਂਤੀ
CCXXXVIII	ਦੋ ਸੌ ਅੜਤੀ
CCXXXIX	ਦੋ ਸੌ ਉਨਤਾਲੀ
CCXL	ਦੋ ਸੌ ਚਾਲੀ
CCXLI	ਦੋ ਸੌ ਇਕਤਾਲੀ
CCXLII	ਦੋ ਸੌ ਬਿਆਲੀ
CCXLIII	ਦੋ ਸੌ ਤਰਤਾਲੀ
CCXLIV	ਦੋ ਸੌ ਚਵਾਲੀ
CCXLV	ਦੋ ਸੌ ਪੈਂਤਾਲੀ
CCXLVI	ਦੋ ਸੌ ਛਿਆਲੀ
CCXLVII	ਦੋ ਸੌ ਸੈਂਤਾਲੀ
CCXLVIII	ਦੋ ਸੌ ਅੜਤਾਲੀ
CCXLIX	ਦੋ ਸੌ ਉਨੰਜਾ
CCL	ਦੋ ਸੌ ਪੰਜਾਹ
CCLI	ਦੋ ਸੌ ਇਕਵੰਜਾ
CCLII	ਦੋ ਸੌ ਬਵੰਜਾ
CCLIII	ਦੋ ਸੌ ਤਰਵੰਜਾ
CCLIV	ਦੋ ਸੌ ਚੁਰੰਜਾ
CCLV	ਦੋ ਸੌ ਪਚਵੰਜਾ
CCLVI	ਦੋ ਸੌ ਛਪੰਜਾ
CCLVII	ਦੋ ਸੌ ਸਤਵੰਜਾ
CCLVIII	ਦੋ ਸੌ ਅਠਵੰਜਾ
CCLIX	ਦੋ ਸੌ ਉਨੱਠ
CCLX	ਦੋ ਸੌ ਸੱਠ
CCLXI	ਦੋ ਸੌ ਇਕਠ
CCLXII	ਦੋ ਸੌ ਬਾਠ
CCLXIII	ਦੋ ਸੌ ਤਰੇਠ
CCLXIV	ਦੋ ਸੌ ਚੌਂਠ
CCLXV	ਦੋ ਸੌ ਪੈਂਠ
CCLXVI	ਦੋ ਸੌ ਛਿਆਠ
CCLXVII	ਦੋ ਸੌ ਸਤੱਠ
CCLXVIII	ਦੋ ਸੌ ਅਠੱਠ
CCLXIX	ਦੋ ਸੌ ਉਨੱਤਰ
CCLXX	ਦੋ ਸੌ ਸੱਤਰ
CCLXXI	ਦੋ ਸੌ ਇਕੱਤਰ
CCLXXII	ਦੋ ਸੌ ਬਹੱਤਰ
CCLXXIII	ਦੋ ਸੌ ਤਿਹੱਤਰ
CCLXXIV	ਦੋ ਸੌ ਚੁਹੱਤਰ
CCLXXV	ਦੋ ਸੌ ਪੰਝੱਤਰ
CCLXXVI	ਦੋ ਸੌ ਛਿਹੱਤਰ
CCLXXVII	ਦੋ ਸੌ ਸਤੱਤਰ
CCLXXVIII	ਦੋ ਸੌ ਅਠੱਤਰ
CCLXXIX	ਦੋ ਸੌ ਉਨਾਸੀ
CCLXXX	ਦੋ ਸੌ ਅੱਸੀ
CCLXXXI	ਦੋ ਸੌ ਇਕਾਸੀ
CCLXXXII	ਦੋ ਸੌ ਬਿਆਸੀ
CCLXXXIII	ਦੋ ਸੌ ਤਿਰਾਸੀ
CCLXXXIV	ਦੋ ਸੌ ਚੁਰਾਸੀ
CCLXXXV	ਦੋ ਸੌ ਪਚਾਸੀ
CCLXXXVI	ਦੋ ਸੌ ਛਿਆਸੀ
CCLXXXVII	ਦੋ ਸੌ ਸਤਾਸੀ
CCLXXXVIII	ਦੋ ਸੌ ਅਠਾਸੀ
CCLXXXIX	ਦੋ ਸੌ ਨਵਾਸੀ
CCXC	ਦੋ ਸੌ ਨੱਬੇ
CCXCI	ਦੋ ਸੌ ਇਕਾਨਵੇਂ
CCXCII	ਦੋ ਸੌ ਬਾਨਵੇਂ
CCXCIII	ਦੋ ਸੌ ਤਰਾਨਵੇਂ
CCXCIV	ਦੋ ਸੌ ਚੁਰਾਨਵੇਂ
CCXCV	ਦੋ ਸੌ ਪਚਾਨਵੇਂ
CCXCVI	ਦੋ ਸੌ ਛਿਆਨਵੇਂ
CCXCVII	ਦੋ ਸੌ ਸਤਾਨਵੇਂ
CCXCVIII	ਦੋ ਸੌ ਅਠਾਨਵੇਂ
CCXCIX	ਦੋ ਸੌ ਨਿਨਾਨਵੇਂ
CCC	ਤਿੰਨ ਸੌ
CCCI	ਤਿੰਨ ਸੌ ਇੱਕ
CCCII	ਤਿੰਨ ਸੌ ਦੋ
CCCIII	ਤਿੰਨ ਸੌ ਤਿੰਨ
CCCIV	ਤਿੰਨ ਸੌ ਚਾਰ
CCCV	ਤਿੰਨ ਸੌ ਪੰਜ
CCCVI	ਤਿੰਨ ਸੌ ਛੇ
CCCVII	ਤਿੰਨ ਸੌ ਸੱਤ
CCCVIII	ਤਿੰਨ ਸੌ ਅੱਠ
CCCIX	ਤਿੰਨ ਸੌ ਨੌਂ
CCCX	ਤਿੰਨ ਸੌ ਦਸ
CCCXI	ਤਿੰਨ ਸੌ ਗਿਆਰਾਂ
CCCXII	ਤਿੰਨ ਸੌ ਬਾਰਾਂ
CCCXIII	ਤਿੰਨ ਸੌ ਤੇਰਾਂ
CCCXIV	ਤਿੰਨ ਸੌ ਚੌਦਾਂ
CCCXV	ਤਿੰਨ ਸੌ ਪੰਦਰਾਂ
CCCXVI	ਤਿੰਨ ਸੌ ਸੋਲਾਂ
CCCXVII	ਤਿੰਨ ਸੌ ਸਤਾਰਾਂ
CCCXVIII	ਤਿੰਨ ਸੌ ਅਠਾਰਾਂ
CCCXIX	ਤਿੰਨ ਸੌ ਉੱਨੀ
CCCXX	ਤਿੰਨ ਸੌ ਵੀਹ
CCCXXI	ਤਿੰਨ ਸੌ ਇੱਕੀ
CCCXXII	ਤਿੰਨ ਸੌ ਬਾਈ
CCCXXIII	ਤਿੰਨ ਸੌ ਤੇਈ
CCCXXIV	ਤਿੰਨ ਸੌ ਚੌਬੀ
CCCXXV	ਤਿੰਨ ਸੌ ਪੱਚੀ
CCCXXVI	ਤਿੰਨ ਸੌ ਛੱਬੀ
CCCXXVII	ਤਿੰਨ ਸੌ ਸਤਾਈ
CCCXXVIII	ਤਿੰਨ ਸੌ ਅਠਾਈ
CCCXXIX	ਤਿੰਨ ਸੌ ਉਨੱਤੀ
CCCXXX	ਤਿੰਨ ਸੌ ਤੀਹ
CCCXXXI	ਤਿੰਨ ਸੌ ਇਕੱਤੀ
CCCXXXII	ਤਿੰਨ ਸੌ ਬੱਤੀ
CCCXXXIII	ਤਿੰਨ ਸੌ ਤੇਤੀ
CCCXXXIV	ਤਿੰਨ ਸੌ ਚੌਂਤੀ
CCCXXXV	ਤਿੰਨ ਸੌ ਪੈਂਤੀ
CCCXXXVI	ਤਿੰਨ ਸੌ ਛੱਤੀ
CCCXXXVII	ਤਿੰਨ ਸੌ ਸੈਂਤੀ
CCCXXXVIII	ਤਿੰਨ ਸੌ ਅੜਤੀ
CCCXXXIX	ਤਿੰਨ ਸੌ ਉਨਤਾਲੀ
CCCXL	ਤਿੰਨ ਸੌ ਚਾਲੀ
CCCXLI	ਤਿੰਨ ਸੌ ਇਕਤਾਲੀ
CCCXLII	ਤਿੰਨ ਸੌ ਬਿਆਲੀ
CCCXLIII	ਤਿੰਨ ਸੌ ਤਰਤਾਲੀ
CCCXLIV	ਤਿੰਨ ਸੌ ਚਵਾਲੀ
CCCXLV	ਤਿੰਨ ਸੌ ਪੈਂਤਾਲੀ
CCCXLVI	ਤਿੰਨ ਸੌ ਛਿਆਲੀ
CCCXLVII	ਤਿੰਨ ਸੌ ਸੈਂਤਾਲੀ
CCCXLVIII	ਤਿੰਨ ਸੌ ਅੜਤਾਲੀ
CCCXLIX	ਤਿੰਨ ਸੌ ਉਨੰਜਾ
CCCL	ਤਿੰਨ ਸੌ ਪੰਜਾਹ
CCCLI	ਤਿੰਨ ਸੌ ਇਕਵੰਜਾ
CCCLII	ਤਿੰਨ ਸੌ ਬਵੰਜਾ
CCCLIII	ਤਿੰਨ ਸੌ ਤਰਵੰਜਾ
CCCLIV	ਤਿੰਨ ਸੌ ਚੁਰੰਜਾ
CCCLV	ਤਿੰਨ ਸੌ ਪਚਵੰਜਾ
CCCLVI	ਤਿੰਨ ਸੌ ਛਪੰਜਾ
CCCLVII	ਤਿੰਨ ਸੌ ਸਤਵੰਜਾ
CCCLVIII	ਤਿੰਨ ਸੌ ਅਠਵੰਜਾ
CCCLIX	ਤਿੰਨ ਸੌ ਉਨੱਠ
CCCLX	ਤਿੰਨ ਸੌ ਸੱਠ
CCCLXI	ਤਿੰਨ ਸੌ ਇਕਠ
CCCLXII	ਤਿੰਨ ਸੌ ਬਾਠ
CCCLXIII	ਤਿੰਨ ਸੌ ਤਰੇਠ
CCCLXIV	ਤਿੰਨ ਸੌ ਚੌਂਠ
CCCLXV	ਤਿੰਨ ਸੌ ਪੈਂਠ
CCCLXVI	ਤਿੰਨ ਸੌ ਛਿਆਠ
CCCLXVII	ਤਿੰਨ ਸੌ ਸਤੱਠ
CCCLXVIII	ਤਿੰਨ ਸੌ ਅਠੱਠ
CCCLXIX	ਤਿੰਨ ਸੌ ਉਨੱਤਰ
CCCLXX	ਤਿੰਨ ਸੌ ਸੱਤਰ
CCCLXXI	ਤਿੰਨ ਸੌ ਇਕੱਤਰ
CCCLXXII	ਤਿੰਨ ਸੌ ਬਹੱਤਰ
CCCLXXIII	ਤਿੰਨ ਸੌ ਤਿਹੱਤਰ
CCCLXXIV	ਤਿੰਨ ਸੌ ਚੁਹੱਤਰ
CCCLXXV	ਤਿੰਨ ਸੌ ਪੰਝੱਤਰ
CCCLXXVI	ਤਿੰਨ ਸੌ ਛਿਹੱਤਰ
CCCLXXVII	ਤਿੰਨ ਸੌ ਸਤੱਤਰ
CCCLXXVIII	ਤਿੰਨ ਸੌ ਅਠੱਤਰ
CCCLXXIX	ਤਿੰਨ ਸੌ ਉਨਾਸੀ
CCCLXXX	ਤਿੰਨ ਸੌ ਅੱਸੀ
CCCLXXXI	ਤਿੰਨ ਸੌ ਇਕਾਸੀ
CCCLXXXII	ਤਿੰਨ ਸੌ ਬਿਆਸੀ
CCCLXXXIII	ਤਿੰਨ ਸੌ ਤਿਰਾਸੀ
CCCLXXXIV	ਤਿੰਨ ਸੌ ਚੁਰਾਸੀ
CCCLXXXV	ਤਿੰਨ ਸੌ ਪਚਾਸੀ
CCCLXXXVI	ਤਿੰਨ ਸੌ ਛਿਆਸੀ
CCCLXXXVII	ਤਿੰਨ ਸੌ ਸਤਾਸੀ
CCCLXXXVIII	ਤਿੰਨ ਸੌ ਅਠਾਸੀ
CCCLXXXIX	ਤਿੰਨ ਸੌ ਨਵਾਸੀ
CCCXC	ਤਿੰਨ ਸੌ ਨੱਬੇ
CCCXCI	ਤਿੰਨ ਸੌ ਇਕਾਨਵੇਂ
CCCXCII	ਤਿੰਨ ਸੌ ਬਾਨਵੇਂ
CCCXCIII	ਤਿੰਨ ਸੌ ਤਰਾਨਵੇਂ
CCCXCIV	ਤਿੰਨ ਸੌ ਚੁਰਾਨਵੇਂ
CCCXCV	ਤਿੰਨ ਸੌ ਪਚਾਨਵੇਂ
CCCXCVI	ਤਿੰਨ ਸੌ ਛਿਆਨਵੇਂ
CCCXCVII	ਤਿੰਨ ਸੌ ਸਤਾਨਵੇਂ
CCCXCVIII	ਤਿੰਨ ਸੌ ਅਠਾਨਵੇਂ
CCCXCIX	ਤਿੰਨ ਸੌ ਨਿਨਾਨਵੇਂ
CD	ਚਾਰ ਸੌ
CDI	ਚਾਰ ਸੌ ਇੱਕ
CDII	ਚਾਰ ਸੌ ਦੋ
CDIII	ਚਾਰ ਸੌ ਤਿੰਨ
CDIV	ਚਾਰ ਸੌ ਚਾਰ
CDV	ਚਾਰ ਸੌ ਪੰਜ
CDVI	ਚਾਰ ਸੌ ਛੇ
CDVII	ਚਾਰ ਸੌ ਸੱਤ
CDVIII	ਚਾਰ ਸੌ ਅੱਠ
CDIX	ਚਾਰ ਸੌ ਨੌਂ
CDX	ਚਾਰ ਸੌ ਦਸ
CDXI	ਚਾਰ ਸੌ ਗਿਆਰਾਂ
CDXII	ਚਾਰ ਸੌ ਬਾਰਾਂ
CDXIII	ਚਾਰ ਸੌ ਤੇਰਾਂ
CDXIV	ਚਾਰ ਸੌ ਚੌਦਾਂ
CDXV	ਚਾਰ ਸੌ ਪੰਦਰਾਂ
CDXVI	ਚਾਰ ਸੌ ਸੋਲਾਂ
CDXVII	ਚਾਰ ਸੌ ਸਤਾਰਾਂ
CDXVIII	ਚਾਰ ਸੌ ਅਠਾਰਾਂ
CDXIX	ਚਾਰ ਸੌ ਉੱਨੀ
CDXX	ਚਾਰ ਸੌ ਵੀਹ
CDXXI	ਚਾਰ ਸੌ ਇੱਕੀ
CDXXII	ਚਾਰ ਸੌ ਬਾਈ
CDXXIII	ਚਾਰ ਸੌ ਤੇਈ
CDXXIV	ਚਾਰ ਸੌ ਚੌਬੀ
CDXXV	ਚਾਰ ਸੌ ਪੱਚੀ
CDXXVI	ਚਾਰ ਸੌ ਛੱਬੀ
CDXXVII	ਚਾਰ ਸੌ ਸਤਾਈ
CDXXVIII	ਚਾਰ ਸੌ ਅਠਾਈ
CDXXIX	ਚਾਰ ਸੌ ਉਨੱਤੀ
CDXXX	ਚਾਰ ਸੌ ਤੀਹ
CDXXXI	ਚਾਰ ਸੌ ਇਕੱਤੀ
CDXXXII	ਚਾਰ ਸੌ ਬੱਤੀ
CDXXXIII	ਚਾਰ ਸੌ ਤੇਤੀ
CDXXXIV	ਚਾਰ ਸੌ ਚੌਂਤੀ
CDXXXV	ਚਾਰ ਸੌ ਪੈਂਤੀ
CDXXXVI	ਚਾਰ ਸੌ ਛੱਤੀ
CDXXXVII	ਚਾਰ ਸੌ ਸੈਂਤੀ
CDXXXVIII	ਚਾਰ ਸੌ ਅੜਤੀ
CDXXXIX	ਚਾਰ ਸੌ ਉਨਤਾਲੀ
CDXL	ਚਾਰ ਸੌ ਚਾਲੀ
CDXLI	ਚਾਰ ਸੌ ਇਕਤਾਲੀ
CDXLII	ਚਾਰ ਸੌ ਬਿਆਲੀ
CDXLIII	ਚਾਰ ਸੌ ਤਰਤਾਲੀ
CDXLIV	ਚਾਰ ਸੌ ਚਵਾਲੀ
CDXLV	ਚਾਰ ਸੌ ਪੈਂਤਾਲੀ
CDXLVI	ਚਾਰ ਸੌ ਛਿਆਲੀ
CDXLVII	ਚਾਰ ਸੌ ਸੈਂਤਾਲੀ
CDXLVIII	ਚਾਰ ਸੌ ਅੜਤਾਲੀ
CDXLIX	ਚਾਰ ਸੌ ਉਨੰਜਾ
CDL	ਚਾਰ ਸੌ ਪੰਜਾਹ
CDLI	ਚਾਰ ਸੌ ਇਕਵੰਜਾ
CDLII	ਚਾਰ ਸੌ ਬਵੰਜਾ
CDLIII	ਚਾਰ ਸੌ ਤਰਵੰਜਾ
CDLIV	ਚਾਰ ਸੌ ਚੁਰੰਜਾ
CDLV	ਚਾਰ ਸੌ ਪਚਵੰਜਾ
CDLVI	ਚਾਰ ਸੌ ਛਪੰਜਾ
CDLVII	ਚਾਰ ਸੌ ਸਤਵੰਜਾ
CDLVIII	ਚਾਰ ਸੌ ਅਠਵੰਜਾ
CDLIX	ਚਾਰ ਸੌ ਉਨੱਠ
CDLX	ਚਾਰ ਸੌ ਸੱਠ
CDLXI	ਚਾਰ ਸੌ ਇਕਠ
CDLXII	ਚਾਰ ਸੌ ਬਾਠ
CDLXIII	ਚਾਰ ਸੌ ਤਰੇਠ
CDLXIV	ਚਾਰ ਸੌ ਚੌਂਠ
CDLXV	ਚਾਰ ਸੌ ਪੈਂਠ
CDLXVI	ਚਾਰ ਸੌ ਛਿਆਠ
CDLXVII	ਚਾਰ ਸੌ ਸਤੱਠ
CDLXVIII	ਚਾਰ ਸੌ ਅਠੱਠ
CDLXIX	ਚਾਰ ਸੌ ਉਨੱਤਰ
CDLXX	ਚਾਰ ਸੌ ਸੱਤਰ
CDLXXI	ਚਾਰ ਸੌ ਇਕੱਤਰ
CDLXXII	ਚਾਰ ਸੌ ਬਹੱਤਰ
CDLXXIII	ਚਾਰ ਸੌ ਤਿਹੱਤਰ
CDLXXIV	ਚਾਰ ਸੌ ਚੁਹੱਤਰ
CDLXXV	ਚਾਰ ਸੌ ਪੰਝੱਤਰ
CDLXXVI	ਚਾਰ ਸੌ ਛਿਹੱਤਰ
CDLXXVII	ਚਾਰ ਸੌ ਸਤੱਤਰ
CDLXXVIII	ਚਾਰ ਸੌ ਅਠੱਤਰ
CDLXXIX	ਚਾਰ ਸੌ ਉਨਾਸੀ
CDLXXX	ਚਾਰ ਸੌ ਅੱਸੀ
CDLXXXI	ਚਾਰ ਸੌ ਇਕਾਸੀ
CDLXXXII	ਚਾਰ ਸੌ ਬਿਆਸੀ
CDLXXXIII	ਚਾਰ ਸੌ ਤਿਰਾਸੀ
CDLXXXIV	ਚਾਰ ਸੌ ਚੁਰਾਸੀ
CDLXXXV	ਚਾਰ ਸੌ ਪਚਾਸੀ
CDLXXXVI	ਚਾਰ ਸੌ ਛਿਆਸੀ
CDLXXXVII	ਚਾਰ ਸੌ ਸਤਾਸੀ
CDLXXXVIII	ਚਾਰ ਸੌ ਅਠਾਸੀ
CDLXXXIX	ਚਾਰ ਸੌ ਨਵਾਸੀ
CDXC	ਚਾਰ ਸੌ ਨੱਬੇ
CDXCI	ਚਾਰ ਸੌ ਇਕਾਨਵੇਂ
CDXCII	ਚਾਰ ਸੌ ਬਾਨਵੇਂ
CDXCIII	ਚਾਰ ਸੌ ਤਰਾਨਵੇਂ
CDXCIV	ਚਾਰ ਸੌ ਚੁਰਾਨਵੇਂ
CDXCV	ਚਾਰ ਸੌ ਪਚਾਨਵੇਂ
CDXCVI	ਚਾਰ ਸੌ ਛਿਆਨਵੇਂ
CDXCVII	ਚਾਰ ਸੌ ਸਤਾਨਵੇਂ
CDXCVIII	ਚਾਰ ਸੌ ਅਠਾਨਵੇਂ
CDXCIX	ਚਾਰ ਸੌ ਨਿਨਾਨਵੇਂ
D	ਪੰਜ ਸੌ
DI	ਪੰਜ ਸੌ ਇੱਕ
DII	ਪੰਜ ਸੌ ਦੋ
DIII	ਪੰਜ ਸੌ ਤਿੰਨ
DIV	ਪੰਜ ਸੌ ਚਾਰ
DV	ਪੰਜ ਸੌ ਪੰਜ
DVI	ਪੰਜ ਸੌ ਛੇ
DVII	ਪੰਜ ਸੌ ਸੱਤ
DVIII	ਪੰਜ ਸੌ ਅੱਠ
DIX	ਪੰਜ ਸੌ ਨੌਂ
DX	ਪੰਜ ਸੌ ਦਸ
DXI	ਪੰਜ ਸੌ ਗਿਆਰਾਂ
DXII	ਪੰਜ ਸੌ ਬਾਰਾਂ
DXIII	ਪੰਜ ਸੌ ਤੇਰਾਂ
DXIV	ਪੰਜ ਸੌ ਚੌਦਾਂ
DXV	ਪੰਜ ਸੌ ਪੰਦਰਾਂ
DXVI	ਪੰਜ ਸੌ ਸੋਲਾਂ
DXVII	ਪੰਜ ਸੌ ਸਤਾਰਾਂ
DXVIII	ਪੰਜ ਸੌ ਅਠਾਰਾਂ
DXIX	ਪੰਜ ਸੌ ਉੱਨੀ
DXX	ਪੰਜ ਸੌ ਵੀਹ
DXXI	ਪੰਜ ਸੌ ਇੱਕੀ
DXXII	ਪੰਜ ਸੌ ਬਾਈ
DXXIII	ਪੰਜ ਸੌ ਤੇਈ
DXXIV	ਪੰਜ ਸੌ ਚੌਬੀ
DXXV	ਪੰਜ ਸੌ ਪੱਚੀ
DXXVI	ਪੰਜ ਸੌ ਛੱਬੀ
DXXVII	ਪੰਜ ਸੌ ਸਤਾਈ
DXXVIII	ਪੰਜ ਸੌ ਅਠਾਈ
DXXIX	ਪੰਜ ਸੌ ਉਨੱਤੀ
DXXX	ਪੰਜ ਸੌ ਤੀਹ
DXXXI	ਪੰਜ ਸੌ ਇਕੱਤੀ
DXXXII	ਪੰਜ ਸੌ ਬੱਤੀ
DXXXIII	ਪੰਜ ਸੌ ਤੇਤੀ
DXXXIV	ਪੰਜ ਸੌ ਚੌਂਤੀ
DXXXV	ਪੰਜ ਸੌ ਪੈਂਤੀ
DXXXVI	ਪੰਜ ਸੌ ਛੱਤੀ
DXXXVII	ਪੰਜ ਸੌ ਸੈਂਤੀ
DXXXVIII	ਪੰਜ ਸੌ ਅੜਤੀ
DXXXIX	ਪੰਜ ਸੌ ਉਨਤਾਲੀ
DXL	ਪੰਜ ਸੌ ਚਾਲੀ
DXLI	ਪੰਜ ਸੌ ਇਕਤਾਲੀ
DXLII	ਪੰਜ ਸੌ ਬਿਆਲੀ
DXLIII	ਪੰਜ ਸੌ ਤਰਤਾਲੀ
DXLIV	ਪੰਜ ਸੌ ਚਵਾਲੀ
DXLV	ਪੰਜ ਸੌ ਪੈਂਤਾਲੀ
DXLVI	ਪੰਜ ਸੌ ਛਿਆਲੀ
DXLVII	ਪੰਜ ਸੌ ਸੈਂਤਾਲੀ
DXLVIII	ਪੰਜ ਸੌ ਅੜਤਾਲੀ
DXLIX	ਪੰਜ ਸੌ ਉਨੰਜਾ
DL	ਪੰਜ ਸੌ ਪੰਜਾਹ
DLI	ਪੰਜ ਸੌ ਇਕਵੰਜਾ
DLII	ਪੰਜ ਸੌ ਬਵੰਜਾ
DLIII	ਪੰਜ ਸੌ ਤਰਵੰਜਾ
DLIV	ਪੰਜ ਸੌ ਚੁਰੰਜਾ
DLV	ਪੰਜ ਸੌ ਪਚਵੰਜਾ
DLVI	ਪੰਜ ਸੌ ਛਪੰਜਾ
DLVII	ਪੰਜ ਸੌ ਸਤਵੰਜਾ
DLVIII	ਪੰਜ ਸੌ ਅਠਵੰਜਾ
DLIX	ਪੰਜ ਸੌ ਉਨੱਠ
DLX	ਪੰਜ ਸੌ ਸੱਠ
DLXI	ਪੰਜ ਸੌ ਇਕਠ
DLXII	ਪੰਜ ਸੌ ਬਾਠ
DLXIII	ਪੰਜ ਸੌ ਤਰੇਠ
DLXIV	ਪੰਜ ਸੌ ਚੌਂਠ
DLXV	ਪੰਜ ਸੌ ਪੈਂਠ
DLXVI	ਪੰਜ ਸੌ ਛਿਆਠ
DLXVII	ਪੰਜ ਸੌ ਸਤੱਠ
DLXVIII	ਪੰਜ ਸੌ ਅਠੱਠ
DLXIX	ਪੰਜ ਸੌ ਉਨੱਤਰ
DLXX	ਪੰਜ ਸੌ ਸੱਤਰ
DLXXI	ਪੰਜ ਸੌ ਇਕੱਤਰ
DLXXII	ਪੰਜ ਸੌ ਬਹੱਤਰ
DLXXIII	ਪੰਜ ਸੌ ਤਿਹੱਤਰ
DLXXIV	ਪੰਜ ਸੌ ਚੁਹੱਤਰ
DLXXV	ਪੰਜ ਸੌ ਪੰਝੱਤਰ
DLXXVI	ਪੰਜ ਸੌ ਛਿਹੱਤਰ
DLXXVII	ਪੰਜ ਸੌ ਸਤੱਤਰ
DLXXVIII	ਪੰਜ ਸੌ ਅਠੱਤਰ
DLXXIX	ਪੰਜ ਸੌ ਉਨਾਸੀ
DLXXX	ਪੰਜ ਸੌ ਅੱਸੀ
DLXXXI	ਪੰਜ ਸੌ ਇਕਾਸੀ
DLXXXII	ਪੰਜ ਸੌ ਬਿਆਸੀ
DLXXXIII	ਪੰਜ ਸੌ ਤਿਰਾਸੀ
DLXXXIV	ਪੰਜ ਸੌ ਚੁਰਾਸੀ
DLXXXV	ਪੰਜ ਸੌ ਪਚਾਸੀ
DLXXXVI	ਪੰਜ ਸੌ ਛਿਆਸੀ
DLXXXVII	ਪੰਜ ਸੌ ਸਤਾਸੀ
DLXXXVIII	ਪੰਜ ਸੌ ਅਠਾਸੀ
DLXXXIX	ਪੰਜ ਸੌ ਨਵਾਸੀ
DXC	ਪੰਜ ਸੌ ਨੱਬੇ
DXCI	ਪੰਜ ਸੌ ਇਕਾਨਵੇਂ
DXCII	ਪੰਜ ਸੌ ਬਾਨਵੇਂ
DXCIII	ਪੰਜ ਸੌ ਤਰਾਨਵੇਂ
DXCIV	ਪੰਜ ਸੌ ਚੁਰਾਨਵੇਂ
DXCV	ਪੰਜ ਸੌ ਪਚਾਨਵੇਂ
DXCVI	ਪੰਜ ਸੌ ਛਿਆਨਵੇਂ
DXCVII	ਪੰਜ ਸੌ ਸਤਾਨਵੇਂ
DXCVIII	ਪੰਜ ਸੌ ਅਠਾਨਵੇਂ
DXCIX	ਪੰਜ ਸੌ ਨਿਨਾਨਵੇਂ
DC	ਛੇ ਸੌ
DCI	ਛੇ ਸੌ ਇੱਕ
DCII	ਛੇ ਸੌ ਦੋ
DCIII	ਛੇ ਸੌ ਤਿੰਨ
DCIV	ਛੇ ਸੌ ਚਾਰ
DCV	ਛੇ ਸੌ ਪੰਜ
DCVI	ਛੇ ਸੌ ਛੇ
DCVII	ਛੇ ਸੌ ਸੱਤ
DCVIII	ਛੇ ਸੌ ਅੱਠ
DCIX	ਛੇ ਸੌ ਨੌਂ
DCX	ਛੇ ਸੌ ਦਸ
DCXI	ਛੇ ਸੌ ਗਿਆਰਾਂ
DCXII	ਛੇ ਸੌ ਬਾਰਾਂ
DCXIII	ਛੇ ਸੌ ਤੇਰਾਂ
DCXIV	ਛੇ ਸੌ ਚੌਦਾਂ
DCXV	ਛੇ ਸੌ ਪੰਦਰਾਂ
DCXVI	ਛੇ ਸੌ ਸੋਲਾਂ
DCXVII	ਛੇ ਸੌ ਸਤਾਰਾਂ
DCXVIII	ਛੇ ਸੌ ਅਠਾਰਾਂ
DCXIX	ਛੇ ਸੌ ਉੱਨੀ
DCXX	ਛੇ ਸੌ ਵੀਹ
DCXXI	ਛੇ ਸੌ ਇੱਕੀ
DCXXII	ਛੇ ਸੌ ਬਾਈ
DCXXIII	ਛੇ ਸੌ ਤੇਈ
DCXXIV	ਛੇ ਸੌ ਚੌਬੀ
DCXXV	ਛੇ ਸੌ ਪੱਚੀ
DCXXVI	ਛੇ ਸੌ ਛੱਬੀ
DCXXVII	ਛੇ ਸੌ ਸਤਾਈ
DCXXVIII	ਛੇ ਸੌ ਅਠਾਈ
DCXXIX	ਛੇ ਸੌ ਉਨੱਤੀ
DCXXX	ਛੇ ਸੌ ਤੀਹ
DCXXXI	ਛੇ ਸੌ ਇਕੱਤੀ
DCXXXII	ਛੇ ਸੌ ਬੱਤੀ
DCXXXIII	ਛੇ ਸੌ ਤੇਤੀ
DCXXXIV	ਛੇ ਸੌ ਚੌਂਤੀ
DCXXXV	ਛੇ ਸੌ ਪੈਂਤੀ
DCXXXVI	ਛੇ ਸੌ ਛੱਤੀ
DCXXXVII	ਛੇ ਸੌ ਸੈਂਤੀ
DCXXXVIII	ਛੇ ਸੌ ਅੜਤੀ
DCXXXIX	ਛੇ ਸੌ ਉਨਤਾਲੀ
DCXL	ਛੇ ਸੌ ਚਾਲੀ
DCXLI	ਛੇ ਸੌ ਇਕਤਾਲੀ
DCXLII	ਛੇ ਸੌ ਬਿਆਲੀ
DCXLIII	ਛੇ ਸੌ ਤਰਤਾਲੀ
DCXLIV	ਛੇ ਸੌ ਚਵਾਲੀ
DCXLV	ਛੇ ਸੌ ਪੈਂਤਾਲੀ
DCXLVI	ਛੇ ਸੌ ਛਿਆਲੀ
DCXLVII	ਛੇ ਸੌ ਸੈਂਤਾਲੀ
DCXLVIII	ਛੇ ਸੌ ਅੜਤਾਲੀ
DCXLIX	ਛੇ ਸੌ ਉਨੰਜਾ
DCL	ਛੇ ਸੌ ਪੰਜਾਹ
DCLI	ਛੇ ਸੌ ਇਕਵੰਜਾ
DCLII	ਛੇ ਸੌ ਬਵੰਜਾ
DCLIII	ਛੇ ਸੌ ਤਰਵੰਜਾ
DCLIV	ਛੇ ਸੌ ਚੁਰੰਜਾ
DCLV	ਛੇ ਸੌ ਪਚਵੰਜਾ
DCLVI	ਛੇ ਸੌ ਛਪੰਜਾ
DCLVII	ਛੇ ਸੌ ਸਤਵੰਜਾ
DCLVIII	ਛੇ ਸੌ ਅਠਵੰਜਾ
DCLIX	ਛੇ ਸੌ ਉਨੱਠ
DCLX	ਛੇ ਸੌ ਸੱਠ
DCLXI	ਛੇ ਸੌ ਇਕਠ
DCLXII	ਛੇ ਸੌ ਬਾਠ
DCLXIII	ਛੇ ਸੌ ਤਰੇਠ
DCLXIV	ਛੇ ਸੌ ਚੌਂਠ
DCLXV	ਛੇ ਸੌ ਪੈਂਠ
DCLXVI	ਛੇ ਸੌ ਛਿਆਠ
DCLXVII	ਛੇ ਸੌ ਸਤੱਠ
DCLXVIII	ਛੇ ਸੌ ਅਠੱਠ
DCLXIX	ਛੇ ਸੌ ਉਨੱਤਰ
DCLXX	ਛੇ ਸੌ ਸੱਤਰ
DCLXXI	ਛੇ ਸੌ ਇਕੱਤਰ
DCLXXII	ਛੇ ਸੌ ਬਹੱਤਰ
DCLXXIII	ਛੇ ਸੌ ਤਿਹੱਤਰ
DCLXXIV	ਛੇ ਸੌ ਚੁਹੱਤਰ
DCLXXV	ਛੇ ਸੌ ਪੰਝੱਤਰ
DCLXXVI	ਛੇ ਸੌ ਛਿਹੱਤਰ
DCLXXVII	ਛੇ ਸੌ ਸਤੱਤਰ
DCLXXVIII	ਛੇ ਸੌ ਅਠੱਤਰ
DCLXXIX	ਛੇ ਸੌ ਉਨਾਸੀ
DCLXXX	ਛੇ ਸੌ ਅੱਸੀ
DCLXXXI	ਛੇ ਸੌ ਇਕਾਸੀ
DCLXXXII	ਛੇ ਸੌ ਬਿਆਸੀ
DCLXXXIII	ਛੇ ਸੌ ਤਿਰਾਸੀ
DCLXXXIV	ਛੇ ਸੌ ਚੁਰਾਸੀ
DCLXXXV	ਛੇ ਸੌ ਪਚਾਸੀ
DCLXXXVI	ਛੇ ਸੌ ਛਿਆਸੀ
DCLXXXVII	ਛੇ ਸੌ ਸਤਾਸੀ
DCLXXXVIII	ਛੇ ਸੌ ਅਠਾਸੀ
DCLXXXIX	ਛੇ ਸੌ ਨਵਾਸੀ
DCXC	ਛੇ ਸੌ ਨੱਬੇ
DCXCI	ਛੇ ਸੌ ਇਕਾਨਵੇਂ
DCXCII	ਛੇ ਸੌ ਬਾਨਵੇਂ
DCXCIII	ਛੇ ਸੌ ਤਰਾਨਵੇਂ
DCXCIV	ਛੇ ਸੌ ਚੁਰਾਨਵੇਂ
DCXCV	ਛੇ ਸੌ ਪਚਾਨਵੇਂ
DCXCVI	ਛੇ ਸੌ ਛਿਆਨਵੇਂ
DCXCVII	ਛੇ ਸੌ ਸਤਾਨਵੇਂ
DCXCVIII	ਛੇ ਸੌ ਅਠਾਨਵੇਂ
DCXCIX	ਛੇ ਸੌ ਨਿਨਾਨਵੇਂ
DCC	ਸੱਤ ਸੌ
DCCI	ਸੱਤ ਸੌ ਇੱਕ
DCCII	ਸੱਤ ਸੌ ਦੋ
DCCIII	ਸੱਤ ਸੌ ਤਿੰਨ
DCCIV	ਸੱਤ ਸੌ ਚਾਰ
DCCV	ਸੱਤ ਸੌ ਪੰਜ
DCCVI	ਸੱਤ ਸੌ ਛੇ
DCCVII	ਸੱਤ ਸੌ ਸੱਤ
DCCVIII	ਸੱਤ ਸੌ ਅੱਠ
DCCIX	ਸੱਤ ਸੌ ਨੌਂ
DCCX	ਸੱਤ ਸੌ ਦਸ
DCCXI	ਸੱਤ ਸੌ ਗਿਆਰਾਂ
DCCXII	ਸੱਤ ਸੌ ਬਾਰਾਂ
DCCXIII	ਸੱਤ ਸੌ ਤੇਰਾਂ
DCCXIV	ਸੱਤ ਸੌ ਚੌਦਾਂ
DCCXV	ਸੱਤ ਸੌ ਪੰਦਰਾਂ
DCCXVI	ਸੱਤ ਸੌ ਸੋਲਾਂ
DCCXVII	ਸੱਤ ਸੌ ਸਤਾਰਾਂ
DCCXVIII	ਸੱਤ ਸੌ ਅਠਾਰਾਂ
DCCXIX	ਸੱਤ ਸੌ ਉੱਨੀ
DCCXX	ਸੱਤ ਸੌ ਵੀਹ
DCCXXI	ਸੱਤ ਸੌ ਇੱਕੀ
DCCXXII	ਸੱਤ ਸੌ ਬਾਈ
DCCXXIII	ਸੱਤ ਸੌ ਤੇਈ
DCCXXIV	ਸੱਤ ਸੌ ਚੌਬੀ
DCCXXV	ਸੱਤ ਸੌ ਪੱਚੀ
DCCXXVI	ਸੱਤ ਸੌ ਛੱਬੀ
DCCXXVII	ਸੱਤ ਸੌ ਸਤਾਈ
DCCXXVIII	ਸੱਤ ਸੌ ਅਠਾਈ
DCCXXIX	ਸੱਤ ਸੌ ਉਨੱਤੀ
DCCXXX	ਸੱਤ ਸੌ ਤੀਹ
DCCXXXI	ਸੱਤ ਸੌ ਇਕੱਤੀ
DCCXXXII	ਸੱਤ ਸੌ ਬੱਤੀ
DCCXXXIII	ਸੱਤ ਸੌ ਤੇਤੀ
DCCXXXIV	ਸੱਤ ਸੌ ਚੌਂਤੀ
DCCXXXV	ਸੱਤ ਸੌ ਪੈਂਤੀ
DCCXXXVI	ਸੱਤ ਸੌ ਛੱਤੀ
DCCXXXVII	ਸੱਤ ਸੌ ਸੈਂਤੀ
DCCXXXVIII	ਸੱਤ ਸੌ ਅੜਤੀ
DCCXXXIX	ਸੱਤ ਸੌ ਉਨਤਾਲੀ
DCCXL	ਸੱਤ ਸੌ ਚਾਲੀ
DCCXLI	ਸੱਤ ਸੌ ਇਕਤਾਲੀ
DCCXLII	ਸੱਤ ਸੌ ਬਿਆਲੀ
DCCXLIII	ਸੱਤ ਸੌ ਤਰਤਾਲੀ
DCCXLIV	ਸੱਤ ਸੌ ਚਵਾਲੀ
DCCXLV	ਸੱਤ ਸੌ ਪੈਂਤਾਲੀ
DCCXLVI	ਸੱਤ ਸੌ ਛਿਆਲੀ
DCCXLVII	ਸੱਤ ਸੌ ਸੈਂਤਾਲੀ
DCCXLVIII	ਸੱਤ ਸੌ ਅੜਤਾਲੀ
DCCXLIX	ਸੱਤ ਸੌ ਉਨੰਜਾ
DCCL	ਸੱਤ ਸੌ ਪੰਜਾਹ
DCCLI	ਸੱਤ ਸੌ ਇਕਵੰਜਾ
DCCLII	ਸੱਤ ਸੌ ਬਵੰਜਾ
DCCLIII	ਸੱਤ ਸੌ ਤਰਵੰਜਾ
DCCLIV	ਸੱਤ ਸੌ ਚੁਰੰਜਾ
DCCLV	ਸੱਤ ਸੌ ਪਚਵੰਜਾ
DCCLVI	ਸੱਤ ਸੌ ਛਪੰਜਾ
DCCLVII	ਸੱਤ ਸੌ ਸਤਵੰਜਾ
DCCLVIII	ਸੱਤ ਸੌ ਅਠਵੰਜਾ
DCCLIX	ਸੱਤ ਸੌ ਉਨੱਠ
DCCLX	ਸੱਤ ਸੌ ਸੱਠ
DCCLXI	ਸੱਤ ਸੌ ਇਕਠ
DCCLXII	ਸੱਤ ਸੌ ਬਾਠ
DCCLXIII	ਸੱਤ ਸੌ ਤਰੇਠ
DCCLXIV	ਸੱਤ ਸੌ ਚੌਂਠ
DCCLXV	ਸੱਤ ਸੌ ਪੈਂਠ
DCCLXVI	ਸੱਤ ਸੌ ਛਿਆਠ
DCCLXVII	ਸੱਤ ਸੌ ਸਤੱਠ
DCCLXVIII	ਸੱਤ ਸੌ ਅਠੱਠ
DCCLXIX	ਸੱਤ ਸੌ ਉਨੱਤਰ
DCCLXX	ਸੱਤ ਸੌ ਸੱਤਰ
DCCLXXI	ਸੱਤ ਸੌ ਇਕੱਤਰ
DCCLXXII	ਸੱਤ ਸੌ ਬਹੱਤਰ
DCCLXXIII	ਸੱਤ ਸੌ ਤਿਹੱਤਰ
DCCLXXIV	ਸੱਤ ਸੌ ਚੁਹੱਤਰ
DCCLXXV	ਸੱਤ ਸੌ ਪੰਝੱਤਰ
DCCLXXVI	ਸੱਤ ਸੌ ਛਿਹੱਤਰ
DCCLXXVII	ਸੱਤ ਸੌ ਸਤੱਤਰ
DCCLXXVIII	ਸੱਤ ਸੌ ਅਠੱਤਰ
DCCLXXIX	ਸੱਤ ਸੌ ਉਨਾਸੀ
DCCLXXX	ਸੱਤ ਸੌ ਅੱਸੀ
DCCLXXXI	ਸੱਤ ਸੌ ਇਕਾਸੀ
DCCLXXXII	ਸੱਤ ਸੌ ਬਿਆਸੀ
DCCLXXXIII	ਸੱਤ ਸੌ ਤਿਰਾਸੀ
DCCLXXXIV	ਸੱਤ ਸੌ ਚੁਰਾਸੀ
DCCLXXXV	ਸੱਤ ਸੌ ਪਚਾਸੀ
DCCLXXXVI	ਸੱਤ ਸੌ ਛਿਆਸੀ
DCCLXXXVII	ਸੱਤ ਸੌ ਸਤਾਸੀ
DCCLXXXVIII	ਸੱਤ ਸੌ ਅਠਾਸੀ
DCCLXXXIX	ਸੱਤ ਸੌ ਨਵਾਸੀ
DCCXC	ਸੱਤ ਸੌ ਨੱਬੇ
DCCXCI	ਸੱਤ ਸੌ ਇਕਾਨਵੇਂ
DCCXCII	ਸੱਤ ਸੌ ਬਾਨਵੇਂ
DCCXCIII	ਸੱਤ ਸੌ ਤਰਾਨਵੇਂ
DCCXCIV	ਸੱਤ ਸੌ ਚੁਰਾਨਵੇਂ
DCCXCV	ਸੱਤ ਸੌ ਪਚਾਨਵੇਂ
DCCXCVI	ਸੱਤ ਸੌ ਛਿਆਨਵੇਂ
DCCXCVII	ਸੱਤ ਸੌ ਸਤਾਨਵੇਂ
DCCXCVIII	ਸੱਤ ਸੌ ਅਠਾਨਵੇਂ
DCCXCIX	ਸੱਤ ਸੌ ਨਿਨਾਨਵੇਂ
DCCC	ਅੱਠ ਸੌ
DCCCI	ਅੱਠ ਸੌ ਇੱਕ
DCCCII	ਅੱਠ ਸੌ ਦੋ
DCCCIII	ਅੱਠ ਸੌ ਤਿੰਨ
DCCCIV	ਅੱਠ ਸੌ ਚਾਰ
DCCCV	ਅੱਠ ਸੌ ਪੰਜ
DCCCVI	ਅੱਠ ਸੌ ਛੇ
DCCCVII	ਅੱਠ ਸੌ ਸੱਤ
DCCCVIII	ਅੱਠ ਸੌ ਅੱਠ
DCCCIX	ਅੱਠ ਸੌ ਨੌਂ
DCCCX	ਅੱਠ ਸੌ ਦਸ
DCCCXI	ਅੱਠ ਸੌ ਗਿਆਰਾਂ
DCCCXII	ਅੱਠ ਸੌ ਬਾਰਾਂ
DCCCXIII	ਅੱਠ ਸੌ ਤੇਰਾਂ
DCCCXIV	ਅੱਠ ਸੌ ਚੌਦਾਂ
DCCCXV	ਅੱਠ ਸੌ ਪੰਦਰਾਂ
DCCCXVI	ਅੱਠ ਸੌ ਸੋਲਾਂ
DCCCXVII	ਅੱਠ ਸੌ ਸਤਾਰਾਂ
DCCCXVIII	ਅੱਠ ਸੌ ਅਠਾਰਾਂ
DCCCXIX	ਅੱਠ ਸੌ ਉੱਨੀ
DCCCXX	ਅੱਠ ਸੌ ਵੀਹ
DCCCXXI	ਅੱਠ ਸੌ ਇੱਕੀ
DCCCXXII	ਅੱਠ ਸੌ ਬਾਈ
DCCCXXIII	ਅੱਠ ਸੌ ਤੇਈ
DCCCXXIV	ਅੱਠ ਸੌ ਚੌਬੀ
DCCCXXV	ਅੱਠ ਸੌ ਪੱਚੀ
DCCCXXVI	ਅੱਠ ਸੌ ਛੱਬੀ
DCCCXXVII	ਅੱਠ ਸੌ ਸਤਾਈ
DCCCXXVIII	ਅੱਠ ਸੌ ਅਠਾਈ
DCCCXXIX	ਅੱਠ ਸੌ ਉਨੱਤੀ
DCCCXXX	ਅੱਠ ਸੌ ਤੀਹ
DCCCXXXI	ਅੱਠ ਸੌ ਇਕੱਤੀ
DCCCXXXII	ਅੱਠ ਸੌ ਬੱਤੀ
DCCCXXXIII	ਅੱਠ ਸੌ ਤੇਤੀ
DCCCXXXIV	ਅੱਠ ਸੌ ਚੌਂਤੀ
DCCCXXXV	ਅੱਠ ਸੌ ਪੈਂਤੀ
DCCCXXXVI	ਅੱਠ ਸੌ ਛੱਤੀ
DCCCXXXVII	ਅੱਠ ਸੌ ਸੈਂਤੀ
DCCCXXXVIII	ਅੱਠ ਸੌ ਅੜਤੀ
DCCCXXXIX	ਅੱਠ ਸੌ ਉਨਤਾਲੀ
DCCCXL	ਅੱਠ ਸੌ ਚਾਲੀ
DCCCXLI	ਅੱਠ ਸੌ ਇਕਤਾਲੀ
DCCCXLII	ਅੱਠ ਸੌ ਬਿਆਲੀ
DCCCXLIII	ਅੱਠ ਸੌ ਤਰਤਾਲੀ
DCCCXLIV	ਅੱਠ ਸੌ ਚਵਾਲੀ
DCCCXLV	ਅੱਠ ਸੌ ਪੈਂਤਾਲੀ
DCCCXLVI	ਅੱਠ ਸੌ ਛਿਆਲੀ
DCCCXLVII	ਅੱਠ ਸੌ ਸੈਂਤਾਲੀ
DCCCXLVIII	ਅੱਠ ਸੌ ਅੜਤਾਲੀ
DCCCXLIX	ਅੱਠ ਸੌ ਉਨੰਜਾ
DCCCL	ਅੱਠ ਸੌ ਪੰਜਾਹ
DCCCLI	ਅੱਠ ਸੌ ਇਕਵੰਜਾ
DCCCLII	ਅੱਠ ਸੌ ਬਵੰਜਾ
DCCCLIII	ਅੱਠ ਸੌ ਤਰਵੰਜਾ
DCCCLIV	ਅੱਠ ਸੌ ਚੁਰੰਜਾ
DCCCLV	ਅੱਠ ਸੌ ਪਚਵੰਜਾ
DCCCLVI	ਅੱਠ ਸੌ ਛਪੰਜਾ
DCCCLVII	ਅੱਠ ਸੌ ਸਤਵੰਜਾ
DCCCLVIII	ਅੱਠ ਸੌ ਅਠਵੰਜਾ
DCCCLIX	ਅੱਠ ਸੌ ਉਨੱਠ
DCCCLX	ਅੱਠ ਸੌ ਸੱਠ
DCCCLXI	ਅੱਠ ਸੌ ਇਕਠ
DCCCLXII	ਅੱਠ ਸੌ ਬਾਠ
DCCCLXIII	ਅੱਠ ਸੌ ਤਰੇਠ
DCCCLXIV	ਅੱਠ ਸੌ ਚੌਂਠ
DCCCLXV	ਅੱਠ ਸੌ ਪੈਂਠ
DCCCLXVI	ਅੱਠ ਸੌ ਛਿਆਠ
DCCCLXVII	ਅੱਠ ਸੌ ਸਤੱਠ
DCCCLXVIII	ਅੱਠ ਸੌ ਅਠੱਠ
DCCCLXIX	ਅੱਠ ਸੌ ਉਨੱਤਰ
DCCCLXX	ਅੱਠ ਸੌ ਸੱਤਰ
DCCCLXXI	ਅੱਠ ਸੌ ਇਕੱਤਰ
DCCCLXXII	ਅੱਠ ਸੌ ਬਹੱਤਰ
DCCCLXXIII	ਅੱਠ ਸੌ ਤਿਹੱਤਰ
DCCCLXXIV	ਅੱਠ ਸੌ ਚੁਹੱਤਰ
DCCCLXXV	ਅੱਠ ਸੌ ਪੰਝੱਤਰ
DCCCLXXVI	ਅੱਠ ਸੌ ਛਿਹੱਤਰ
DCCCLXXVII	ਅੱਠ ਸੌ ਸਤੱਤਰ
DCCCLXXVIII	ਅੱਠ ਸੌ ਅਠੱਤਰ
DCCCLXXIX	ਅੱਠ ਸੌ ਉਨਾਸੀ
DCCCLXXX	ਅੱਠ ਸੌ ਅੱਸੀ
DCCCLXXXI	ਅੱਠ ਸੌ ਇਕਾਸੀ
DCCCLXXXII	ਅੱਠ ਸੌ ਬਿਆਸੀ
DCCCLXXXIII	ਅੱਠ ਸੌ ਤਿਰਾਸੀ
DCCCLXXXIV	ਅੱਠ ਸੌ ਚੁਰਾਸੀ
DCCCLXXXV	ਅੱਠ ਸੌ ਪਚਾਸੀ
DCCCLXXXVI	ਅੱਠ ਸੌ ਛਿਆਸੀ
DCCCLXXXVII	ਅੱਠ ਸੌ ਸਤਾਸੀ
DCCCLXXXVIII	ਅੱਠ ਸੌ ਅਠਾਸੀ
DCCCLXXXIX	ਅੱਠ ਸੌ ਨਵਾਸੀ
DCCCXC	ਅੱਠ ਸੌ ਨੱਬੇ
DCCCXCI	ਅੱਠ ਸੌ ਇਕਾਨਵੇਂ
DCCCXCII	ਅੱਠ ਸੌ ਬਾਨਵੇਂ
DCCCXCIII	ਅੱਠ ਸੌ ਤਰਾਨਵੇਂ
DCCCXCIV	ਅੱਠ ਸੌ ਚੁਰਾਨਵੇਂ
DCCCXCV	ਅੱਠ ਸੌ ਪਚਾਨਵੇਂ
DCCCXCVI	ਅੱਠ ਸੌ ਛਿਆਨਵੇਂ
DCCCXCVII	ਅੱਠ ਸੌ ਸਤਾਨਵੇਂ
DCCCXCVIII	ਅੱਠ ਸੌ ਅਠਾਨਵੇਂ
DCCCXCIX	ਅੱਠ ਸੌ ਨਿਨਾਨਵੇਂ
CM	ਨੌਂ ਸੌ
CMI	ਨੌਂ ਸੌ ਇੱਕ
CMII	ਨੌਂ ਸੌ ਦੋ
CMIII	ਨੌਂ ਸੌ ਤਿੰਨ
CMIV	ਨੌਂ ਸੌ ਚਾਰ
CMV	ਨੌਂ ਸੌ ਪੰਜ
CMVI	ਨੌਂ ਸੌ ਛੇ
CMVII	ਨੌਂ ਸੌ ਸੱਤ
CMVIII	ਨੌਂ ਸੌ ਅੱਠ
CMIX	ਨੌਂ ਸੌ ਨੌਂ
CMX	ਨੌਂ ਸੌ ਦਸ
CMXI	ਨੌਂ ਸੌ ਗਿਆਰਾਂ
CMXII	ਨੌਂ ਸੌ ਬਾਰਾਂ
CMXIII	ਨੌਂ ਸੌ ਤੇਰਾਂ
CMXIV	ਨੌਂ ਸੌ ਚੌਦਾਂ
CMXV	ਨੌਂ ਸੌ ਪੰਦਰਾਂ
CMXVI	ਨੌਂ ਸੌ ਸੋਲਾਂ
CMXVII	ਨੌਂ ਸੌ ਸਤਾਰਾਂ
CMXVIII	ਨੌਂ ਸੌ ਅਠਾਰਾਂ
CMXIX	ਨੌਂ ਸੌ ਉੱਨੀ
CMXX	ਨੌਂ ਸੌ ਵੀਹ
CMXXI	ਨੌਂ ਸੌ ਇੱਕੀ
CMXXII	ਨੌਂ ਸੌ ਬਾਈ
CMXXIII	ਨੌਂ ਸੌ ਤੇਈ
CMXXIV	ਨੌਂ ਸੌ ਚੌਬੀ
CMXXV	ਨੌਂ ਸੌ ਪੱਚੀ
CMXXVI	ਨੌਂ ਸੌ ਛੱਬੀ
CMXXVII	ਨੌਂ ਸੌ ਸਤਾਈ
CMXXVIII	ਨੌਂ ਸੌ ਅਠਾਈ
CMXXIX	ਨੌਂ ਸੌ ਉਨੱਤੀ
CMXXX	ਨੌਂ ਸੌ ਤੀਹ
CMXXXI	ਨੌਂ ਸੌ ਇਕੱਤੀ
CMXXXII	ਨੌਂ ਸੌ ਬੱਤੀ
CMXXXIII	ਨੌਂ ਸੌ ਤੇਤੀ
CMXXXIV	ਨੌਂ ਸੌ ਚੌਂਤੀ
CMXXXV	ਨੌਂ ਸੌ ਪੈਂਤੀ
CMXXXVI	ਨੌਂ ਸੌ ਛੱਤੀ
CMXXXVII	ਨੌਂ ਸੌ ਸੈਂਤੀ
CMXXXVIII	ਨੌਂ ਸੌ ਅੜਤੀ
CMXXXIX	ਨੌਂ ਸੌ ਉਨਤਾਲੀ
CMXL	ਨੌਂ ਸੌ ਚਾਲੀ
CMXLI	ਨੌਂ ਸੌ ਇਕਤਾਲੀ
CMXLII	ਨੌਂ ਸੌ ਬਿਆਲੀ
CMXLIII	ਨੌਂ ਸੌ ਤਰਤਾਲੀ
CMXLIV	ਨੌਂ ਸੌ ਚਵਾਲੀ
CMXLV	ਨੌਂ ਸੌ ਪੈਂਤਾਲੀ
CMXLVI	ਨੌਂ ਸੌ ਛਿਆਲੀ
CMXLVII	ਨੌਂ ਸੌ ਸੈਂਤਾਲੀ
CMXLVIII	ਨੌਂ ਸੌ ਅੜਤਾਲੀ
CMXLIX	ਨੌਂ ਸੌ ਉਨੰਜਾ
CML	ਨੌਂ ਸੌ ਪੰਜਾਹ
CMLI	ਨੌਂ ਸੌ ਇਕਵੰਜਾ
CMLII	ਨੌਂ ਸੌ ਬਵੰਜਾ
CMLIII	ਨੌਂ ਸੌ ਤਰਵੰਜਾ
CMLIV	ਨੌਂ ਸੌ ਚੁਰੰਜਾ
CMLV	ਨੌਂ ਸੌ ਪਚਵੰਜਾ
CMLVI	ਨੌਂ ਸੌ ਛਪੰਜਾ
CMLVII	ਨੌਂ ਸੌ ਸਤਵੰਜਾ
CMLVIII	ਨੌਂ ਸੌ ਅਠਵੰਜਾ
CMLIX	ਨੌਂ ਸੌ ਉਨੱਠ
CMLX	ਨੌਂ ਸੌ ਸੱਠ
CMLXI	ਨੌਂ ਸੌ ਇਕਠ
CMLXII	ਨੌਂ ਸੌ ਬਾਠ
CMLXIII	ਨੌਂ ਸੌ ਤਰੇਠ
CMLXIV	ਨੌਂ ਸੌ ਚੌਂਠ
CMLXV	ਨੌਂ ਸੌ ਪੈਂਠ
CMLXVI	ਨੌਂ ਸੌ ਛਿਆਠ
CMLXVII	ਨੌਂ ਸੌ ਸਤੱਠ
CMLXVIII	ਨੌਂ ਸੌ ਅਠੱਠ
CMLXIX	ਨੌਂ ਸੌ ਉਨੱਤਰ
CMLXX	ਨੌਂ ਸੌ ਸੱਤਰ
CMLXXI	ਨੌਂ ਸੌ ਇਕੱਤਰ
CMLXXII	ਨੌਂ ਸੌ ਬਹੱਤਰ
CMLXXIII	ਨੌਂ ਸੌ ਤਿਹੱਤਰ
CMLXXIV	ਨੌਂ ਸੌ ਚੁਹੱਤਰ
CMLXXV	ਨੌਂ ਸੌ ਪੰਝੱਤਰ
CMLXXVI	ਨੌਂ ਸੌ ਛਿਹੱਤਰ
CMLXXVII	ਨੌਂ ਸੌ ਸਤੱਤਰ
CMLXXVIII	ਨੌਂ ਸੌ ਅਠੱਤਰ
CMLXXIX	ਨੌਂ ਸੌ ਉਨਾਸੀ
CMLXXX	ਨੌਂ ਸੌ ਅੱਸੀ
CMLXXXI	ਨੌਂ ਸੌ ਇਕਾਸੀ
CMLXXXII	ਨੌਂ ਸੌ ਬਿਆਸੀ
CMLXXXIII	ਨੌਂ ਸੌ ਤਿਰਾਸੀ
CMLXXXIV	ਨੌਂ ਸੌ ਚੁਰਾਸੀ
CMLXXXV	ਨੌਂ ਸੌ ਪਚਾਸੀ
CMLXXXVI	ਨੌਂ ਸੌ ਛਿਆਸੀ
CMLXXXVII	ਨੌਂ ਸੌ ਸਤਾਸੀ
CMLXXXVIII	ਨੌਂ ਸੌ ਅਠਾਸੀ
CMLXXXIX	ਨੌਂ ਸੌ ਨਵਾਸੀ
CMXC	ਨੌਂ ਸੌ ਨੱਬੇ
CMXCI	ਨੌਂ ਸੌ ਇਕਾਨਵੇਂ
CMXCII	ਨੌਂ ਸੌ ਬਾਨਵੇਂ
CMXCIII	ਨੌਂ ਸੌ ਤਰਾਨਵੇਂ
CMXCIV	ਨੌਂ ਸੌ ਚੁਰਾਨਵੇਂ
CMXCV	ਨੌਂ ਸੌ ਪਚਾਨਵੇਂ
CMXCVI	ਨੌਂ ਸੌ ਛਿਆਨਵੇਂ
CMXCVII	ਨੌਂ ਸੌ ਸਤਾਨਵੇਂ
CMXCVIII	ਨੌਂ ਸੌ ਅਠਾਨਵੇਂ
CMXCIX	ਨੌਂ ਸੌ ਨਿਨਾਨਵੇਂ
M	ਇੱਕ हज़ार
MI	ਇੱਕ हज़ार ਇੱਕ
MII	ਇੱਕ हज़ार ਦੋ
MIII	ਇੱਕ हज़ार ਤਿੰਨ
MIV	ਇੱਕ हज़ार ਚਾਰ
MV	ਇੱਕ हज़ार ਪੰਜ
MVI	ਇੱਕ हज़ार ਛੇ
MVII	ਇੱਕ हज़ार ਸੱਤ
MVIII	ਇੱਕ हज़ार ਅੱਠ
MIX	ਇੱਕ हज़ार ਨੌਂ
MX	ਇੱਕ हज़ार ਦਸ
MXI	ਇੱਕ हज़ार ਗਿਆਰਾਂ
MXII	ਇੱਕ हज़ार ਬਾਰਾਂ
MXIII	ਇੱਕ हज़ार ਤੇਰਾਂ
MXIV	ਇੱਕ हज़ार ਚੌਦਾਂ
MXV	ਇੱਕ हज़ार ਪੰਦਰਾਂ
MXVI	ਇੱਕ हज़ार ਸੋਲਾਂ
MXVII	ਇੱਕ हज़ार ਸਤਾਰਾਂ
MXVIII	ਇੱਕ हज़ार ਅਠਾਰਾਂ
MXIX	ਇੱਕ हज़ार ਉੱਨੀ
MXX	ਇੱਕ हज़ार ਵੀਹ
MXXI	ਇੱਕ हज़ार ਇੱਕੀ
MXXII	ਇੱਕ हज़ार ਬਾਈ
MXXIII	ਇੱਕ हज़ार ਤੇਈ
MXXIV	ਇੱਕ हज़ार ਚੌਬੀ
MXXV	ਇੱਕ हज़ार ਪੱਚੀ
MXXVI	ਇੱਕ हज़ार ਛੱਬੀ
MXXVII	ਇੱਕ हज़ार ਸਤਾਈ
MXXVIII	ਇੱਕ हज़ार ਅਠਾਈ
MXXIX	ਇੱਕ हज़ार ਉਨੱਤੀ
MXXX	ਇੱਕ हज़ार ਤੀਹ
MXXXI	ਇੱਕ हज़ार ਇਕੱਤੀ
MXXXII	ਇੱਕ हज़ार ਬੱਤੀ
MXXXIII	ਇੱਕ हज़ार ਤੇਤੀ
MXXXIV	ਇੱਕ हज़ार ਚੌਂਤੀ
MXXXV	ਇੱਕ हज़ार ਪੈਂਤੀ
MXXXVI	ਇੱਕ हज़ार ਛੱਤੀ
MXXXVII	ਇੱਕ हज़ार ਸੈਂਤੀ
MXXXVIII	ਇੱਕ हज़ार ਅੜਤੀ
MXXXIX	ਇੱਕ हज़ार ਉਨਤਾਲੀ
MXL	ਇੱਕ हज़ार ਚਾਲੀ
MXLI	ਇੱਕ हज़ार ਇਕਤਾਲੀ
MXLII	ਇੱਕ हज़ार ਬਿਆਲੀ
MXLIII	ਇੱਕ हज़ार ਤਰਤਾਲੀ
MXLIV	ਇੱਕ हज़ार ਚਵਾਲੀ
MXLV	ਇੱਕ हज़ार ਪੈਂਤਾਲੀ
MXLVI	ਇੱਕ हज़ार ਛਿਆਲੀ
MXLVII	ਇੱਕ हज़ार ਸੈਂਤਾਲੀ
MXLVIII	ਇੱਕ हज़ार ਅੜਤਾਲੀ
MXLIX	ਇੱਕ हज़ार ਉਨੰਜਾ
ML	ਇੱਕ हज़ार ਪੰਜਾਹ
MLI	ਇੱਕ हज़ार ਇਕਵੰਜਾ
MLII	ਇੱਕ हज़ार ਬਵੰਜਾ
MLIII	ਇੱਕ हज़ार ਤਰਵੰਜਾ
MLIV	ਇੱਕ हज़ार ਚੁਰੰਜਾ
MLV	ਇੱਕ हज़ार ਪਚਵੰਜਾ
MLVI	ਇੱਕ हज़ार ਛਪੰਜਾ
MLVII	ਇੱਕ हज़ार ਸਤਵੰਜਾ
MLVIII	ਇੱਕ हज़ार ਅਠਵੰਜਾ
MLIX	ਇੱਕ हज़ार ਉਨੱਠ
MLX	ਇੱਕ हज़ार ਸੱਠ
MLXI	ਇੱਕ हज़ार ਇਕਠ
MLXII	ਇੱਕ हज़ार ਬਾਠ
MLXIII	ਇੱਕ हज़ार ਤਰੇਠ
MLXIV	ਇੱਕ हज़ार ਚੌਂਠ
MLXV	ਇੱਕ हज़ार ਪੈਂਠ
MLXVI	ਇੱਕ हज़ार ਛਿਆਠ
MLXVII	ਇੱਕ हज़ार ਸਤੱਠ
MLXVIII	ਇੱਕ हज़ार ਅਠੱਠ
MLXIX	ਇੱਕ हज़ार ਉਨੱਤਰ
MLXX	ਇੱਕ हज़ार ਸੱਤਰ
MLXXI	ਇੱਕ हज़ार ਇਕੱਤਰ
MLXXII	ਇੱਕ हज़ार ਬਹੱਤਰ
MLXXIII	ਇੱਕ हज़ार ਤਿਹੱਤਰ
MLXXIV	ਇੱਕ हज़ार ਚੁਹੱਤਰ
MLXXV	ਇੱਕ हज़ार ਪੰਝੱਤਰ
MLXXVI	ਇੱਕ हज़ार ਛਿਹੱਤਰ
MLXXVII	ਇੱਕ हज़ार ਸਤੱਤਰ
MLXXVIII	ਇੱਕ हज़ार ਅਠੱਤਰ
MLXXIX	ਇੱਕ हज़ार ਉਨਾਸੀ
MLXXX	ਇੱਕ हज़ार ਅੱਸੀ
MLXXXI	ਇੱਕ हज़ार ਇਕਾਸੀ
MLXXXII	ਇੱਕ हज़ार ਬਿਆਸੀ
MLXXXIII	ਇੱਕ हज़ार ਤਿਰਾਸੀ
MLXXXIV	ਇੱਕ हज़ार ਚੁਰਾਸੀ
MLXXXV	ਇੱਕ हज़ार ਪਚਾਸੀ
MLXXXVI	ਇੱਕ हज़ार ਛਿਆਸੀ
MLXXXVII	ਇੱਕ हज़ार ਸਤਾਸੀ
MLXXXVIII	ਇੱਕ हज़ार ਅਠਾਸੀ
MLXXXIX	ਇੱਕ हज़ार ਨਵਾਸੀ
MXC	ਇੱਕ हज़ार ਨੱਬੇ
MXCI	ਇੱਕ हज़ार ਇਕਾਨਵੇਂ
MXCII	ਇੱਕ हज़ार ਬਾਨਵੇਂ
MXCIII	ਇੱਕ हज़ार ਤਰਾਨਵੇਂ
MXCIV	ਇੱਕ हज़ार ਚੁਰਾਨਵੇਂ
MXCV	ਇੱਕ हज़ार ਪਚਾਨਵੇਂ
MXCVI	ਇੱਕ हज़ार ਛਿਆਨਵੇਂ
MXCVII	ਇੱਕ हज़ार ਸਤਾਨਵੇਂ
MXCVIII	ਇੱਕ हज़ार ਅਠਾਨਵੇਂ
MXCIX	ਇੱਕ हज़ार ਨਿਨਾਨਵੇਂ
MC	ਇੱਕ हज़ार ਇੱਕ ਸੌ
MCI	ਇੱਕ हज़ार ਇੱਕ ਸੌ ਇੱਕ
MCII	ਇੱਕ हज़ार ਇੱਕ ਸੌ ਦੋ
MCIII	ਇੱਕ हज़ार ਇੱਕ ਸੌ ਤਿੰਨ
MCIV	ਇੱਕ हज़ार ਇੱਕ ਸੌ ਚਾਰ
MCV	ਇੱਕ हज़ार ਇੱਕ ਸੌ ਪੰਜ
MCVI	ਇੱਕ हज़ार ਇੱਕ ਸੌ ਛੇ
MCVII	ਇੱਕ हज़ार ਇੱਕ ਸੌ ਸੱਤ
MCVIII	ਇੱਕ हज़ार ਇੱਕ ਸੌ ਅੱਠ
MCIX	ਇੱਕ हज़ार ਇੱਕ ਸੌ ਨੌਂ
MCX	ਇੱਕ हज़ार ਇੱਕ ਸੌ ਦਸ
MCXI	ਇੱਕ हज़ार ਇੱਕ ਸੌ ਗਿਆਰਾਂ
MCXII	ਇੱਕ हज़ार ਇੱਕ ਸੌ ਬਾਰਾਂ
MCXIII	ਇੱਕ हज़ार ਇੱਕ ਸੌ ਤੇਰਾਂ
MCXIV	ਇੱਕ हज़ार ਇੱਕ ਸੌ ਚੌਦਾਂ
MCXV	ਇੱਕ हज़ार ਇੱਕ ਸੌ ਪੰਦਰਾਂ
MCXVI	ਇੱਕ हज़ार ਇੱਕ ਸੌ ਸੋਲਾਂ
MCXVII	ਇੱਕ हज़ार ਇੱਕ ਸੌ ਸਤਾਰਾਂ
MCXVIII	ਇੱਕ हज़ार ਇੱਕ ਸੌ ਅਠਾਰਾਂ
MCXIX	ਇੱਕ हज़ार ਇੱਕ ਸੌ ਉੱਨੀ
MCXX	ਇੱਕ हज़ार ਇੱਕ ਸੌ ਵੀਹ
MCXXI	ਇੱਕ हज़ार ਇੱਕ ਸੌ ਇੱਕੀ
MCXXII	ਇੱਕ हज़ार ਇੱਕ ਸੌ ਬਾਈ
MCXXIII	ਇੱਕ हज़ार ਇੱਕ ਸੌ ਤੇਈ
MCXXIV	ਇੱਕ हज़ार ਇੱਕ ਸੌ ਚੌਬੀ
MCXXV	ਇੱਕ हज़ार ਇੱਕ ਸੌ ਪੱਚੀ
MCXXVI	ਇੱਕ हज़ार ਇੱਕ ਸੌ ਛੱਬੀ
MCXXVII	ਇੱਕ हज़ार ਇੱਕ ਸੌ ਸਤਾਈ
MCXXVIII	ਇੱਕ हज़ार ਇੱਕ ਸੌ ਅਠਾਈ
MCXXIX	ਇੱਕ हज़ार ਇੱਕ ਸੌ ਉਨੱਤੀ
MCXXX	ਇੱਕ हज़ार ਇੱਕ ਸੌ ਤੀਹ
MCXXXI	ਇੱਕ हज़ार ਇੱਕ ਸੌ ਇਕੱਤੀ
MCXXXII	ਇੱਕ हज़ार ਇੱਕ ਸੌ ਬੱਤੀ
MCXXXIII	ਇੱਕ हज़ार ਇੱਕ ਸੌ ਤੇਤੀ
MCXXXIV	ਇੱਕ हज़ार ਇੱਕ ਸੌ ਚੌਂਤੀ
MCXXXV	ਇੱਕ हज़ार ਇੱਕ ਸੌ ਪੈਂਤੀ
MCXXXVI	ਇੱਕ हज़ार ਇੱਕ ਸੌ ਛੱਤੀ
MCXXXVII	ਇੱਕ हज़ार ਇੱਕ ਸੌ ਸੈਂਤੀ
MCXXXVIII	ਇੱਕ हज़ार ਇੱਕ ਸੌ ਅੜਤੀ
MCXXXIX	ਇੱਕ हज़ार ਇੱਕ ਸੌ ਉਨਤਾਲੀ
MCXL	ਇੱਕ हज़ार ਇੱਕ ਸੌ ਚਾਲੀ
MCXLI	ਇੱਕ हज़ार ਇੱਕ ਸੌ ਇਕਤਾਲੀ
MCXLII	ਇੱਕ हज़ार ਇੱਕ ਸੌ ਬਿਆਲੀ
MCXLIII	ਇੱਕ हज़ार ਇੱਕ ਸੌ ਤਰਤਾਲੀ
MCXLIV	ਇੱਕ हज़ार ਇੱਕ ਸੌ ਚਵਾਲੀ
MCXLV	ਇੱਕ हज़ार ਇੱਕ ਸੌ ਪੈਂਤਾਲੀ
MCXLVI	ਇੱਕ हज़ार ਇੱਕ ਸੌ ਛਿਆਲੀ
MCXLVII	ਇੱਕ हज़ार ਇੱਕ ਸੌ ਸੈਂਤਾਲੀ
MCXLVIII	ਇੱਕ हज़ार ਇੱਕ ਸੌ ਅੜਤਾਲੀ
MCXLIX	ਇੱਕ हज़ार ਇੱਕ ਸੌ ਉਨੰਜਾ
MCL	ਇੱਕ हज़ार ਇੱਕ ਸੌ ਪੰਜਾਹ
MCLI	ਇੱਕ हज़ार ਇੱਕ ਸੌ ਇਕਵੰਜਾ
MCLII	ਇੱਕ हज़ार ਇੱਕ ਸੌ ਬਵੰਜਾ
MCLIII	ਇੱਕ हज़ार ਇੱਕ ਸੌ ਤਰਵੰਜਾ
MCLIV	ਇੱਕ हज़ार ਇੱਕ ਸੌ ਚੁਰੰਜਾ
MCLV	ਇੱਕ हज़ार ਇੱਕ ਸੌ ਪਚਵੰਜਾ
MCLVI	ਇੱਕ हज़ार ਇੱਕ ਸੌ ਛਪੰਜਾ
MCLVII	ਇੱਕ हज़ार ਇੱਕ ਸੌ ਸਤਵੰਜਾ
MCLVIII	ਇੱਕ हज़ार ਇੱਕ ਸੌ ਅਠਵੰਜਾ
MCLIX	ਇੱਕ हज़ार ਇੱਕ ਸੌ ਉਨੱਠ
MCLX	ਇੱਕ हज़ार ਇੱਕ ਸੌ ਸੱਠ
MCLXI	ਇੱਕ हज़ार ਇੱਕ ਸੌ ਇਕਠ
MCLXII	ਇੱਕ हज़ार ਇੱਕ ਸੌ ਬਾਠ
MCLXIII	ਇੱਕ हज़ार ਇੱਕ ਸੌ ਤਰੇਠ
MCLXIV	ਇੱਕ हज़ार ਇੱਕ ਸੌ ਚੌਂਠ
MCLXV	ਇੱਕ हज़ार ਇੱਕ ਸੌ ਪੈਂਠ
MCLXVI	ਇੱਕ हज़ार ਇੱਕ ਸੌ ਛਿਆਠ
MCLXVII	ਇੱਕ हज़ार ਇੱਕ ਸੌ ਸਤੱਠ
MCLXVIII	ਇੱਕ हज़ार ਇੱਕ ਸੌ ਅਠੱਠ
MCLXIX	ਇੱਕ हज़ार ਇੱਕ ਸੌ ਉਨੱਤਰ
MCLXX	ਇੱਕ हज़ार ਇੱਕ ਸੌ ਸੱਤਰ
MCLXXI	ਇੱਕ हज़ार ਇੱਕ ਸੌ ਇਕੱਤਰ
MCLXXII	ਇੱਕ हज़ार ਇੱਕ ਸੌ ਬਹੱਤਰ
MCLXXIII	ਇੱਕ हज़ार ਇੱਕ ਸੌ ਤਿਹੱਤਰ
MCLXXIV	ਇੱਕ हज़ार ਇੱਕ ਸੌ ਚੁਹੱਤਰ
MCLXXV	ਇੱਕ हज़ार ਇੱਕ ਸੌ ਪੰਝੱਤਰ
MCLXXVI	ਇੱਕ हज़ार ਇੱਕ ਸੌ ਛਿਹੱਤਰ
MCLXXVII	ਇੱਕ हज़ार ਇੱਕ ਸੌ ਸਤੱਤਰ
MCLXXVIII	ਇੱਕ हज़ार ਇੱਕ ਸੌ ਅਠੱਤਰ
MCLXXIX	ਇੱਕ हज़ार ਇੱਕ ਸੌ ਉਨਾਸੀ
MCLXXX	ਇੱਕ हज़ार ਇੱਕ ਸੌ ਅੱਸੀ
MCLXXXI	ਇੱਕ हज़ार ਇੱਕ ਸੌ ਇਕਾਸੀ
MCLXXXII	ਇੱਕ हज़ार ਇੱਕ ਸੌ ਬਿਆਸੀ
MCLXXXIII	ਇੱਕ हज़ार ਇੱਕ ਸੌ ਤਿਰਾਸੀ
MCLXXXIV	ਇੱਕ हज़ार ਇੱਕ ਸੌ ਚੁਰਾਸੀ
MCLXXXV	ਇੱਕ हज़ार ਇੱਕ ਸੌ ਪਚਾਸੀ
MCLXXXVI	ਇੱਕ हज़ार ਇੱਕ ਸੌ ਛਿਆਸੀ
MCLXXXVII	ਇੱਕ हज़ार ਇੱਕ ਸੌ ਸਤਾਸੀ
MCLXXXVIII	ਇੱਕ हज़ार ਇੱਕ ਸੌ ਅਠਾਸੀ
MCLXXXIX	ਇੱਕ हज़ार ਇੱਕ ਸੌ ਨਵਾਸੀ
MCXC	ਇੱਕ हज़ार ਇੱਕ ਸੌ ਨੱਬੇ
MCXCI	ਇੱਕ हज़ार ਇੱਕ ਸੌ ਇਕਾਨਵੇਂ
MCXCII	ਇੱਕ हज़ार ਇੱਕ ਸੌ ਬਾਨਵੇਂ
MCXCIII	ਇੱਕ हज़ार ਇੱਕ ਸੌ ਤਰਾਨਵੇਂ
MCXCIV	ਇੱਕ हज़ार ਇੱਕ ਸੌ ਚੁਰਾਨਵੇਂ
MCXCV	ਇੱਕ हज़ार ਇੱਕ ਸੌ ਪਚਾਨਵੇਂ
MCXCVI	ਇੱਕ हज़ार ਇੱਕ ਸੌ ਛਿਆਨਵੇਂ
MCXCVII	ਇੱਕ हज़ार ਇੱਕ ਸੌ ਸਤਾਨਵੇਂ
MCXCVIII	ਇੱਕ हज़ार ਇੱਕ ਸੌ ਅਠਾਨਵੇਂ
MCXCIX	ਇੱਕ हज़ार ਇੱਕ ਸੌ ਨਿਨਾਨਵੇਂ
MCC	ਇੱਕ हज़ार ਦੋ ਸੌ
MCCI	ਇੱਕ हज़ार ਦੋ ਸੌ ਇੱਕ
MCCII	ਇੱਕ हज़ार ਦੋ ਸੌ ਦੋ
MCCIII	ਇੱਕ हज़ार ਦੋ ਸੌ ਤਿੰਨ
MCCIV	ਇੱਕ हज़ार ਦੋ ਸੌ ਚਾਰ
MCCV	ਇੱਕ हज़ार ਦੋ ਸੌ ਪੰਜ
MCCVI	ਇੱਕ हज़ार ਦੋ ਸੌ ਛੇ
MCCVII	ਇੱਕ हज़ार ਦੋ ਸੌ ਸੱਤ
MCCVIII	ਇੱਕ हज़ार ਦੋ ਸੌ ਅੱਠ
MCCIX	ਇੱਕ हज़ार ਦੋ ਸੌ ਨੌਂ
MCCX	ਇੱਕ हज़ार ਦੋ ਸੌ ਦਸ
MCCXI	ਇੱਕ हज़ार ਦੋ ਸੌ ਗਿਆਰਾਂ
MCCXII	ਇੱਕ हज़ार ਦੋ ਸੌ ਬਾਰਾਂ
MCCXIII	ਇੱਕ हज़ार ਦੋ ਸੌ ਤੇਰਾਂ
MCCXIV	ਇੱਕ हज़ार ਦੋ ਸੌ ਚੌਦਾਂ
MCCXV	ਇੱਕ हज़ार ਦੋ ਸੌ ਪੰਦਰਾਂ
MCCXVI	ਇੱਕ हज़ार ਦੋ ਸੌ ਸੋਲਾਂ
MCCXVII	ਇੱਕ हज़ार ਦੋ ਸੌ ਸਤਾਰਾਂ
MCCXVIII	ਇੱਕ हज़ार ਦੋ ਸੌ ਅਠਾਰਾਂ
MCCXIX	ਇੱਕ हज़ार ਦੋ ਸੌ ਉੱਨੀ
MCCXX	ਇੱਕ हज़ार ਦੋ ਸੌ ਵੀਹ
MCCXXI	ਇੱਕ हज़ार ਦੋ ਸੌ ਇੱਕੀ
MCCXXII	ਇੱਕ हज़ार ਦੋ ਸੌ ਬਾਈ
MCCXXIII	ਇੱਕ हज़ार ਦੋ ਸੌ ਤੇਈ
MCCXXIV	ਇੱਕ हज़ार ਦੋ ਸੌ ਚੌਬੀ
MCCXXV	ਇੱਕ हज़ार ਦੋ ਸੌ ਪੱਚੀ
MCCXXVI	ਇੱਕ हज़ार ਦੋ ਸੌ ਛੱਬੀ
MCCXXVII	ਇੱਕ हज़ार ਦੋ ਸੌ ਸਤਾਈ
MCCXXVIII	ਇੱਕ हज़ार ਦੋ ਸੌ ਅਠਾਈ
MCCXXIX	ਇੱਕ हज़ार ਦੋ ਸੌ ਉਨੱਤੀ
MCCXXX	ਇੱਕ हज़ार ਦੋ ਸੌ ਤੀਹ
MCCXXXI	ਇੱਕ हज़ार ਦੋ ਸੌ ਇਕੱਤੀ
MCCXXXII	ਇੱਕ हज़ार ਦੋ ਸੌ ਬੱਤੀ
MCCXXXIII	ਇੱਕ हज़ार ਦੋ ਸੌ ਤੇਤੀ
MCCXXXIV	ਇੱਕ हज़ार ਦੋ ਸੌ ਚੌਂਤੀ
MCCXXXV	ਇੱਕ हज़ार ਦੋ ਸੌ ਪੈਂਤੀ
MCCXXXVI	ਇੱਕ हज़ार ਦੋ ਸੌ ਛੱਤੀ
MCCXXXVII	ਇੱਕ हज़ार ਦੋ ਸੌ ਸੈਂਤੀ
MCCXXXVIII	ਇੱਕ हज़ार ਦੋ ਸੌ ਅੜਤੀ
MCCXXXIX	ਇੱਕ हज़ार ਦੋ ਸੌ ਉਨਤਾਲੀ
MCCXL	ਇੱਕ हज़ार ਦੋ ਸੌ ਚਾਲੀ
MCCXLI	ਇੱਕ हज़ार ਦੋ ਸੌ ਇਕਤਾਲੀ
MCCXLII	ਇੱਕ हज़ार ਦੋ ਸੌ ਬਿਆਲੀ
MCCXLIII	ਇੱਕ हज़ार ਦੋ ਸੌ ਤਰਤਾਲੀ
MCCXLIV	ਇੱਕ हज़ार ਦੋ ਸੌ ਚਵਾਲੀ
MCCXLV	ਇੱਕ हज़ार ਦੋ ਸੌ ਪੈਂਤਾਲੀ
MCCXLVI	ਇੱਕ हज़ार ਦੋ ਸੌ ਛਿਆਲੀ
MCCXLVII	ਇੱਕ हज़ार ਦੋ ਸੌ ਸੈਂਤਾਲੀ
MCCXLVIII	ਇੱਕ हज़ार ਦੋ ਸੌ ਅੜਤਾਲੀ
MCCXLIX	ਇੱਕ हज़ार ਦੋ ਸੌ ਉਨੰਜਾ
MCCL	ਇੱਕ हज़ार ਦੋ ਸੌ ਪੰਜਾਹ
MCCLI	ਇੱਕ हज़ार ਦੋ ਸੌ ਇਕਵੰਜਾ
MCCLII	ਇੱਕ हज़ार ਦੋ ਸੌ ਬਵੰਜਾ
MCCLIII	ਇੱਕ हज़ार ਦੋ ਸੌ ਤਰਵੰਜਾ
MCCLIV	ਇੱਕ हज़ार ਦੋ ਸੌ ਚੁਰੰਜਾ
MCCLV	ਇੱਕ हज़ार ਦੋ ਸੌ ਪਚਵੰਜਾ
MCCLVI	ਇੱਕ हज़ार ਦੋ ਸੌ ਛਪੰਜਾ
MCCLVII	ਇੱਕ हज़ार ਦੋ ਸੌ ਸਤਵੰਜਾ
MCCLVIII	ਇੱਕ हज़ार ਦੋ ਸੌ ਅਠਵੰਜਾ
MCCLIX	ਇੱਕ हज़ार ਦੋ ਸੌ ਉਨੱਠ
MCCLX	ਇੱਕ हज़ार ਦੋ ਸੌ ਸੱਠ
MCCLXI	ਇੱਕ हज़ार ਦੋ ਸੌ ਇਕਠ
MCCLXII	ਇੱਕ हज़ार ਦੋ ਸੌ ਬਾਠ
MCCLXIII	ਇੱਕ हज़ार ਦੋ ਸੌ ਤਰੇਠ
MCCLXIV	ਇੱਕ हज़ार ਦੋ ਸੌ ਚੌਂਠ
MCCLXV	ਇੱਕ हज़ार ਦੋ ਸੌ ਪੈਂਠ
MCCLXVI	ਇੱਕ हज़ार ਦੋ ਸੌ ਛਿਆਠ
MCCLXVII	ਇੱਕ हज़ार ਦੋ ਸੌ ਸਤੱਠ
MCCLXVIII	ਇੱਕ हज़ार ਦੋ ਸੌ ਅਠੱਠ
MCCLXIX	ਇੱਕ हज़ार ਦੋ ਸੌ ਉਨੱਤਰ
MCCLXX	ਇੱਕ हज़ार ਦੋ ਸੌ ਸੱਤਰ
MCCLXXI	ਇੱਕ हज़ार ਦੋ ਸੌ ਇਕੱਤਰ
MCCLXXII	ਇੱਕ हज़ार ਦੋ ਸੌ ਬਹੱਤਰ
MCCLXXIII	ਇੱਕ हज़ार ਦੋ ਸੌ ਤਿਹੱਤਰ
MCCLXXIV	ਇੱਕ हज़ार ਦੋ ਸੌ ਚੁਹੱਤਰ
MCCLXXV	ਇੱਕ हज़ार ਦੋ ਸੌ ਪੰਝੱਤਰ
MCCLXXVI	ਇੱਕ हज़ार ਦੋ ਸੌ ਛਿਹੱਤਰ
MCCLXXVII	ਇੱਕ हज़ार ਦੋ ਸੌ ਸਤੱਤਰ
MCCLXXVIII	ਇੱਕ हज़ार ਦੋ ਸੌ ਅਠੱਤਰ
MCCLXXIX	ਇੱਕ हज़ार ਦੋ ਸੌ ਉਨਾਸੀ
MCCLXXX	ਇੱਕ हज़ार ਦੋ ਸੌ ਅੱਸੀ
MCCLXXXI	ਇੱਕ हज़ार ਦੋ ਸੌ ਇਕਾਸੀ
MCCLXXXII	ਇੱਕ हज़ार ਦੋ ਸੌ ਬਿਆਸੀ
MCCLXXXIII	ਇੱਕ हज़ार ਦੋ ਸੌ ਤਿਰਾਸੀ
MCCLXXXIV	ਇੱਕ हज़ार ਦੋ ਸੌ ਚੁਰਾਸੀ
MCCLXXXV	ਇੱਕ हज़ार ਦੋ ਸੌ ਪਚਾਸੀ
MCCLXXXVI	ਇੱਕ हज़ार ਦੋ ਸੌ ਛਿਆਸੀ
MCCLXXXVII	ਇੱਕ हज़ार ਦੋ ਸੌ ਸਤਾਸੀ
MCCLXXXVIII	ਇੱਕ हज़ार ਦੋ ਸੌ ਅਠਾਸੀ
MCCLXXXIX	ਇੱਕ हज़ार ਦੋ ਸੌ ਨਵਾਸੀ
MCCXC	ਇੱਕ हज़ार ਦੋ ਸੌ ਨੱਬੇ
MCCXCI	ਇੱਕ हज़ार ਦੋ ਸੌ ਇਕਾਨਵੇਂ
MCCXCII	ਇੱਕ हज़ार ਦੋ ਸੌ ਬਾਨਵੇਂ
MCCXCIII	ਇੱਕ हज़ार ਦੋ ਸੌ ਤਰਾਨਵੇਂ
MCCXCIV	ਇੱਕ हज़ार ਦੋ ਸੌ ਚੁਰਾਨਵੇਂ
MCCXCV	ਇੱਕ हज़ार ਦੋ ਸੌ ਪਚਾਨਵੇਂ
MCCXCVI	ਇੱਕ हज़ार ਦੋ ਸੌ ਛਿਆਨਵੇਂ
MCCXCVII	ਇੱਕ हज़ार ਦੋ ਸੌ ਸਤਾਨਵੇਂ
MCCXCVIII	ਇੱਕ हज़ार ਦੋ ਸੌ ਅਠਾਨਵੇਂ
MCCXCIX	ਇੱਕ हज़ार ਦੋ ਸੌ ਨਿਨਾਨਵੇਂ
MCCC	ਇੱਕ हज़ार ਤਿੰਨ ਸੌ
MCCCI	ਇੱਕ हज़ार ਤਿੰਨ ਸੌ ਇੱਕ
MCCCII	ਇੱਕ हज़ार ਤਿੰਨ ਸੌ ਦੋ
MCCCIII	ਇੱਕ हज़ार ਤਿੰਨ ਸੌ ਤਿੰਨ
MCCCIV	ਇੱਕ हज़ार ਤਿੰਨ ਸੌ ਚਾਰ
MCCCV	ਇੱਕ हज़ार ਤਿੰਨ ਸੌ ਪੰਜ
MCCCVI	ਇੱਕ हज़ार ਤਿੰਨ ਸੌ ਛੇ
MCCCVII	ਇੱਕ हज़ार ਤਿੰਨ ਸੌ ਸੱਤ
MCCCVIII	ਇੱਕ हज़ार ਤਿੰਨ ਸੌ ਅੱਠ
MCCCIX	ਇੱਕ हज़ार ਤਿੰਨ ਸੌ ਨੌਂ
MCCCX	ਇੱਕ हज़ार ਤਿੰਨ ਸੌ ਦਸ
MCCCXI	ਇੱਕ हज़ार ਤਿੰਨ ਸੌ ਗਿਆਰਾਂ
MCCCXII	ਇੱਕ हज़ार ਤਿੰਨ ਸੌ ਬਾਰਾਂ
MCCCXIII	ਇੱਕ हज़ार ਤਿੰਨ ਸੌ ਤੇਰਾਂ
MCCCXIV	ਇੱਕ हज़ार ਤਿੰਨ ਸੌ ਚੌਦਾਂ
MCCCXV	ਇੱਕ हज़ार ਤਿੰਨ ਸੌ ਪੰਦਰਾਂ
MCCCXVI	ਇੱਕ हज़ार ਤਿੰਨ ਸੌ ਸੋਲਾਂ
MCCCXVII	ਇੱਕ हज़ार ਤਿੰਨ ਸੌ ਸਤਾਰਾਂ
MCCCXVIII	ਇੱਕ हज़ार ਤਿੰਨ ਸੌ ਅਠਾਰਾਂ
MCCCXIX	ਇੱਕ हज़ार ਤਿੰਨ ਸੌ ਉੱਨੀ
MCCCXX	ਇੱਕ हज़ार ਤਿੰਨ ਸੌ ਵੀਹ
MCCCXXI	ਇੱਕ हज़ार ਤਿੰਨ ਸੌ ਇੱਕੀ
MCCCXXII	ਇੱਕ हज़ार ਤਿੰਨ ਸੌ ਬਾਈ
MCCCXXIII	ਇੱਕ हज़ार ਤਿੰਨ ਸੌ ਤੇਈ
MCCCXXIV	ਇੱਕ हज़ार ਤਿੰਨ ਸੌ ਚੌਬੀ
MCCCXXV	ਇੱਕ हज़ार ਤਿੰਨ ਸੌ ਪੱਚੀ
MCCCXXVI	ਇੱਕ हज़ार ਤਿੰਨ ਸੌ ਛੱਬੀ
MCCCXXVII	ਇੱਕ हज़ार ਤਿੰਨ ਸੌ ਸਤਾਈ
MCCCXXVIII	ਇੱਕ हज़ार ਤਿੰਨ ਸੌ ਅਠਾਈ
MCCCXXIX	ਇੱਕ हज़ार ਤਿੰਨ ਸੌ ਉਨੱਤੀ
MCCCXXX	ਇੱਕ हज़ार ਤਿੰਨ ਸੌ ਤੀਹ
MCCCXXXI	ਇੱਕ हज़ार ਤਿੰਨ ਸੌ ਇਕੱਤੀ
MCCCXXXII	ਇੱਕ हज़ार ਤਿੰਨ ਸੌ ਬੱਤੀ
MCCCXXXIII	ਇੱਕ हज़ार ਤਿੰਨ ਸੌ ਤੇਤੀ
MCCCXXXIV	ਇੱਕ हज़ार ਤਿੰਨ ਸੌ ਚੌਂਤੀ
MCCCXXXV	ਇੱਕ हज़ार ਤਿੰਨ ਸੌ ਪੈਂਤੀ
MCCCXXXVI	ਇੱਕ हज़ार ਤਿੰਨ ਸੌ ਛੱਤੀ
MCCCXXXVII	ਇੱਕ हज़ार ਤਿੰਨ ਸੌ ਸੈਂਤੀ
MCCCXXXVIII	ਇੱਕ हज़ार ਤਿੰਨ ਸੌ ਅੜਤੀ
MCCCXXXIX	ਇੱਕ हज़ार ਤਿੰਨ ਸੌ ਉਨਤਾਲੀ
MCCCXL	ਇੱਕ हज़ार ਤਿੰਨ ਸੌ ਚਾਲੀ
MCCCXLI	ਇੱਕ हज़ार ਤਿੰਨ ਸੌ ਇਕਤਾਲੀ
MCCCXLII	ਇੱਕ हज़ार ਤਿੰਨ ਸੌ ਬਿਆਲੀ
MCCCXLIII	ਇੱਕ हज़ार ਤਿੰਨ ਸੌ ਤਰਤਾਲੀ
MCCCXLIV	ਇੱਕ हज़ार ਤਿੰਨ ਸੌ ਚਵਾਲੀ
MCCCXLV	ਇੱਕ हज़ार ਤਿੰਨ ਸੌ ਪੈਂਤਾਲੀ
MCCCXLVI	ਇੱਕ हज़ार ਤਿੰਨ ਸੌ ਛਿਆਲੀ
MCCCXLVII	ਇੱਕ हज़ार ਤਿੰਨ ਸੌ ਸੈਂਤਾਲੀ
MCCCXLVIII	ਇੱਕ हज़ार ਤਿੰਨ ਸੌ ਅੜਤਾਲੀ
MCCCXLIX	ਇੱਕ हज़ार ਤਿੰਨ ਸੌ ਉਨੰਜਾ
MCCCL	ਇੱਕ हज़ार ਤਿੰਨ ਸੌ ਪੰਜਾਹ
MCCCLI	ਇੱਕ हज़ार ਤਿੰਨ ਸੌ ਇਕਵੰਜਾ
MCCCLII	ਇੱਕ हज़ार ਤਿੰਨ ਸੌ ਬਵੰਜਾ
MCCCLIII	ਇੱਕ हज़ार ਤਿੰਨ ਸੌ ਤਰਵੰਜਾ
MCCCLIV	ਇੱਕ हज़ार ਤਿੰਨ ਸੌ ਚੁਰੰਜਾ
MCCCLV	ਇੱਕ हज़ार ਤਿੰਨ ਸੌ ਪਚਵੰਜਾ
MCCCLVI	ਇੱਕ हज़ार ਤਿੰਨ ਸੌ ਛਪੰਜਾ
MCCCLVII	ਇੱਕ हज़ार ਤਿੰਨ ਸੌ ਸਤਵੰਜਾ
MCCCLVIII	ਇੱਕ हज़ार ਤਿੰਨ ਸੌ ਅਠਵੰਜਾ
MCCCLIX	ਇੱਕ हज़ार ਤਿੰਨ ਸੌ ਉਨੱਠ
MCCCLX	ਇੱਕ हज़ार ਤਿੰਨ ਸੌ ਸੱਠ
MCCCLXI	ਇੱਕ हज़ार ਤਿੰਨ ਸੌ ਇਕਠ
MCCCLXII	ਇੱਕ हज़ार ਤਿੰਨ ਸੌ ਬਾਠ
MCCCLXIII	ਇੱਕ हज़ार ਤਿੰਨ ਸੌ ਤਰੇਠ
MCCCLXIV	ਇੱਕ हज़ार ਤਿੰਨ ਸੌ ਚੌਂਠ
MCCCLXV	ਇੱਕ हज़ार ਤਿੰਨ ਸੌ ਪੈਂਠ
MCCCLXVI	ਇੱਕ हज़ार ਤਿੰਨ ਸੌ ਛਿਆਠ
MCCCLXVII	ਇੱਕ हज़ार ਤਿੰਨ ਸੌ ਸਤੱਠ
MCCCLXVIII	ਇੱਕ हज़ार ਤਿੰਨ ਸੌ ਅਠੱਠ
MCCCLXIX	ਇੱਕ हज़ार ਤਿੰਨ ਸੌ ਉਨੱਤਰ
MCCCLXX	ਇੱਕ हज़ार ਤਿੰਨ ਸੌ ਸੱਤਰ
MCCCLXXI	ਇੱਕ हज़ार ਤਿੰਨ ਸੌ ਇਕੱਤਰ
MCCCLXXII	ਇੱਕ हज़ार ਤਿੰਨ ਸੌ ਬਹੱਤਰ
MCCCLXXIII	ਇੱਕ हज़ार ਤਿੰਨ ਸੌ ਤਿਹੱਤਰ
MCCCLXXIV	ਇੱਕ हज़ार ਤਿੰਨ ਸੌ ਚੁਹੱਤਰ
MCCCLXXV	ਇੱਕ हज़ार ਤਿੰਨ ਸੌ ਪੰਝੱਤਰ
MCCCLXXVI	ਇੱਕ हज़ार ਤਿੰਨ ਸੌ ਛਿਹੱਤਰ
MCCCLXXVII	ਇੱਕ हज़ार ਤਿੰਨ ਸੌ ਸਤੱਤਰ
MCCCLXXVIII	ਇੱਕ हज़ार ਤਿੰਨ ਸੌ ਅਠੱਤਰ
MCCCLXXIX	ਇੱਕ हज़ार ਤਿੰਨ ਸੌ ਉਨਾਸੀ
MCCCLXXX	ਇੱਕ हज़ार ਤਿੰਨ ਸੌ ਅੱਸੀ
MCCCLXXXI	ਇੱਕ हज़ार ਤਿੰਨ ਸੌ ਇਕਾਸੀ
MCCCLXXXII	ਇੱਕ हज़ार ਤਿੰਨ ਸੌ ਬਿਆਸੀ
MCCCLXXXIII	ਇੱਕ हज़ार ਤਿੰਨ ਸੌ ਤਿਰਾਸੀ
MCCCLXXXIV	ਇੱਕ हज़ार ਤਿੰਨ ਸੌ ਚੁਰਾਸੀ
MCCCLXXXV	ਇੱਕ हज़ार ਤਿੰਨ ਸੌ ਪਚਾਸੀ
MCCCLXXXVI	ਇੱਕ हज़ार ਤਿੰਨ ਸੌ ਛਿਆਸੀ
MCCCLXXXVII	ਇੱਕ हज़ार ਤਿੰਨ ਸੌ ਸਤਾਸੀ
MCCCLXXXVIII	ਇੱਕ हज़ार ਤਿੰਨ ਸੌ ਅਠਾਸੀ
MCCCLXXXIX	ਇੱਕ हज़ार ਤਿੰਨ ਸੌ ਨਵਾਸੀ
MCCCXC	ਇੱਕ हज़ार ਤਿੰਨ ਸੌ ਨੱਬੇ
MCCCXCI	ਇੱਕ हज़ार ਤਿੰਨ ਸੌ ਇਕਾਨਵੇਂ
MCCCXCII	ਇੱਕ हज़ार ਤਿੰਨ ਸੌ ਬਾਨਵੇਂ
MCCCXCIII	ਇੱਕ हज़ार ਤਿੰਨ ਸੌ ਤਰਾਨਵੇਂ
MCCCXCIV	ਇੱਕ हज़ार ਤਿੰਨ ਸੌ ਚੁਰਾਨਵੇਂ
MCCCXCV	ਇੱਕ हज़ार ਤਿੰਨ ਸੌ ਪਚਾਨਵੇਂ
MCCCXCVI	ਇੱਕ हज़ार ਤਿੰਨ ਸੌ ਛਿਆਨਵੇਂ
MCCCXCVII	ਇੱਕ हज़ार ਤਿੰਨ ਸੌ ਸਤਾਨਵੇਂ
MCCCXCVIII	ਇੱਕ हज़ार ਤਿੰਨ ਸੌ ਅਠਾਨਵੇਂ
MCCCXCIX	ਇੱਕ हज़ार ਤਿੰਨ ਸੌ ਨਿਨਾਨਵੇਂ
MCD	ਇੱਕ हज़ार ਚਾਰ ਸੌ
MCDI	ਇੱਕ हज़ार ਚਾਰ ਸੌ ਇੱਕ
MCDII	ਇੱਕ हज़ार ਚਾਰ ਸੌ ਦੋ
MCDIII	ਇੱਕ हज़ार ਚਾਰ ਸੌ ਤਿੰਨ
MCDIV	ਇੱਕ हज़ार ਚਾਰ ਸੌ ਚਾਰ
MCDV	ਇੱਕ हज़ार ਚਾਰ ਸੌ ਪੰਜ
MCDVI	ਇੱਕ हज़ार ਚਾਰ ਸੌ ਛੇ
MCDVII	ਇੱਕ हज़ार ਚਾਰ ਸੌ ਸੱਤ
MCDVIII	ਇੱਕ हज़ार ਚਾਰ ਸੌ ਅੱਠ
MCDIX	ਇੱਕ हज़ार ਚਾਰ ਸੌ ਨੌਂ
MCDX	ਇੱਕ हज़ार ਚਾਰ ਸੌ ਦਸ
MCDXI	ਇੱਕ हज़ार ਚਾਰ ਸੌ ਗਿਆਰਾਂ
MCDXII	ਇੱਕ हज़ार ਚਾਰ ਸੌ ਬਾਰਾਂ
MCDXIII	ਇੱਕ हज़ार ਚਾਰ ਸੌ ਤੇਰਾਂ
MCDXIV	ਇੱਕ हज़ार ਚਾਰ ਸੌ ਚੌਦਾਂ
MCDXV	ਇੱਕ हज़ार ਚਾਰ ਸੌ ਪੰਦਰਾਂ
MCDXVI	ਇੱਕ हज़ार ਚਾਰ ਸੌ ਸੋਲਾਂ
MCDXVII	ਇੱਕ हज़ार ਚਾਰ ਸੌ ਸਤਾਰਾਂ
MCDXVIII	ਇੱਕ हज़ार ਚਾਰ ਸੌ ਅਠਾਰਾਂ
MCDXIX	ਇੱਕ हज़ार ਚਾਰ ਸੌ ਉੱਨੀ
MCDXX	ਇੱਕ हज़ार ਚਾਰ ਸੌ ਵੀਹ
MCDXXI	ਇੱਕ हज़ार ਚਾਰ ਸੌ ਇੱਕੀ
MCDXXII	ਇੱਕ हज़ार ਚਾਰ ਸੌ ਬਾਈ
MCDXXIII	ਇੱਕ हज़ार ਚਾਰ ਸੌ ਤੇਈ
MCDXXIV	ਇੱਕ हज़ार ਚਾਰ ਸੌ ਚੌਬੀ
MCDXXV	ਇੱਕ हज़ार ਚਾਰ ਸੌ ਪੱਚੀ
MCDXXVI	ਇੱਕ हज़ार ਚਾਰ ਸੌ ਛੱਬੀ
MCDXXVII	ਇੱਕ हज़ार ਚਾਰ ਸੌ ਸਤਾਈ
MCDXXVIII	ਇੱਕ हज़ार ਚਾਰ ਸੌ ਅਠਾਈ
MCDXXIX	ਇੱਕ हज़ार ਚਾਰ ਸੌ ਉਨੱਤੀ
MCDXXX	ਇੱਕ हज़ार ਚਾਰ ਸੌ ਤੀਹ
MCDXXXI	ਇੱਕ हज़ार ਚਾਰ ਸੌ ਇਕੱਤੀ
MCDXXXII	ਇੱਕ हज़ार ਚਾਰ ਸੌ ਬੱਤੀ
MCDXXXIII	ਇੱਕ हज़ार ਚਾਰ ਸੌ ਤੇਤੀ
MCDXXXIV	ਇੱਕ हज़ार ਚਾਰ ਸੌ ਚੌਂਤੀ
MCDXXXV	ਇੱਕ हज़ार ਚਾਰ ਸੌ ਪੈਂਤੀ
MCDXXXVI	ਇੱਕ हज़ार ਚਾਰ ਸੌ ਛੱਤੀ
MCDXXXVII	ਇੱਕ हज़ार ਚਾਰ ਸੌ ਸੈਂਤੀ
MCDXXXVIII	ਇੱਕ हज़ार ਚਾਰ ਸੌ ਅੜਤੀ
MCDXXXIX	ਇੱਕ हज़ार ਚਾਰ ਸੌ ਉਨਤਾਲੀ
MCDXL	ਇੱਕ हज़ार ਚਾਰ ਸੌ ਚਾਲੀ
MCDXLI	ਇੱਕ हज़ार ਚਾਰ ਸੌ ਇਕਤਾਲੀ
MCDXLII	ਇੱਕ हज़ार ਚਾਰ ਸੌ ਬਿਆਲੀ
MCDXLIII	ਇੱਕ हज़ार ਚਾਰ ਸੌ ਤਰਤਾਲੀ
MCDXLIV	ਇੱਕ हज़ार ਚਾਰ ਸੌ ਚਵਾਲੀ
MCDXLV	ਇੱਕ हज़ार ਚਾਰ ਸੌ ਪੈਂਤਾਲੀ
MCDXLVI	ਇੱਕ हज़ार ਚਾਰ ਸੌ ਛਿਆਲੀ
MCDXLVII	ਇੱਕ हज़ार ਚਾਰ ਸੌ ਸੈਂਤਾਲੀ
MCDXLVIII	ਇੱਕ हज़ार ਚਾਰ ਸੌ ਅੜਤਾਲੀ
MCDXLIX	ਇੱਕ हज़ार ਚਾਰ ਸੌ ਉਨੰਜਾ
MCDL	ਇੱਕ हज़ार ਚਾਰ ਸੌ ਪੰਜਾਹ
MCDLI	ਇੱਕ हज़ार ਚਾਰ ਸੌ ਇਕਵੰਜਾ
MCDLII	ਇੱਕ हज़ार ਚਾਰ ਸੌ ਬਵੰਜਾ
MCDLIII	ਇੱਕ हज़ार ਚਾਰ ਸੌ ਤਰਵੰਜਾ
MCDLIV	ਇੱਕ हज़ार ਚਾਰ ਸੌ ਚੁਰੰਜਾ
MCDLV	ਇੱਕ हज़ार ਚਾਰ ਸੌ ਪਚਵੰਜਾ
MCDLVI	ਇੱਕ हज़ार ਚਾਰ ਸੌ ਛਪੰਜਾ
MCDLVII	ਇੱਕ हज़ार ਚਾਰ ਸੌ ਸਤਵੰਜਾ
MCDLVIII	ਇੱਕ हज़ार ਚਾਰ ਸੌ ਅਠਵੰਜਾ
MCDLIX	ਇੱਕ हज़ार ਚਾਰ ਸੌ ਉਨੱਠ
MCDLX	ਇੱਕ हज़ार ਚਾਰ ਸੌ ਸੱਠ
MCDLXI	ਇੱਕ हज़ार ਚਾਰ ਸੌ ਇਕਠ
MCDLXII	ਇੱਕ हज़ार ਚਾਰ ਸੌ ਬਾਠ
MCDLXIII	ਇੱਕ हज़ार ਚਾਰ ਸੌ ਤਰੇਠ
MCDLXIV	ਇੱਕ हज़ार ਚਾਰ ਸੌ ਚੌਂਠ
MCDLXV	ਇੱਕ हज़ार ਚਾਰ ਸੌ ਪੈਂਠ
MCDLXVI	ਇੱਕ हज़ार ਚਾਰ ਸੌ ਛਿਆਠ
MCDLXVII	ਇੱਕ हज़ार ਚਾਰ ਸੌ ਸਤੱਠ
MCDLXVIII	ਇੱਕ हज़ार ਚਾਰ ਸੌ ਅਠੱਠ
MCDLXIX	ਇੱਕ हज़ार ਚਾਰ ਸੌ ਉਨੱਤਰ
MCDLXX	ਇੱਕ हज़ार ਚਾਰ ਸੌ ਸੱਤਰ
MCDLXXI	ਇੱਕ हज़ार ਚਾਰ ਸੌ ਇਕੱਤਰ
MCDLXXII	ਇੱਕ हज़ार ਚਾਰ ਸੌ ਬਹੱਤਰ
MCDLXXIII	ਇੱਕ हज़ार ਚਾਰ ਸੌ ਤਿਹੱਤਰ
MCDLXXIV	ਇੱਕ हज़ार ਚਾਰ ਸੌ ਚੁਹੱਤਰ
MCDLXXV	ਇੱਕ हज़ार ਚਾਰ ਸੌ ਪੰਝੱਤਰ
MCDLXXVI	ਇੱਕ हज़ार ਚਾਰ ਸੌ ਛਿਹੱਤਰ
MCDLXXVII	ਇੱਕ हज़ार ਚਾਰ ਸੌ ਸਤੱਤਰ
MCDLXXVIII	ਇੱਕ हज़ार ਚਾਰ ਸੌ ਅਠੱਤਰ
MCDLXXIX	ਇੱਕ हज़ार ਚਾਰ ਸੌ ਉਨਾਸੀ
MCDLXXX	ਇੱਕ हज़ार ਚਾਰ ਸੌ ਅੱਸੀ
MCDLXXXI	ਇੱਕ हज़ार ਚਾਰ ਸੌ ਇਕਾਸੀ
MCDLXXXII	ਇੱਕ हज़ार ਚਾਰ ਸੌ ਬਿਆਸੀ
MCDLXXXIII	ਇੱਕ हज़ार ਚਾਰ ਸੌ ਤਿਰਾਸੀ
MCDLXXXIV	ਇੱਕ हज़ार ਚਾਰ ਸੌ ਚੁਰਾਸੀ
MCDLXXXV	ਇੱਕ हज़ार ਚਾਰ ਸੌ ਪਚਾਸੀ
MCDLXXXVI	ਇੱਕ हज़ार ਚਾਰ ਸੌ ਛਿਆਸੀ
MCDLXXXVII	ਇੱਕ हज़ार ਚਾਰ ਸੌ ਸਤਾਸੀ
MCDLXXXVIII	ਇੱਕ हज़ार ਚਾਰ ਸੌ ਅਠਾਸੀ
MCDLXXXIX	ਇੱਕ हज़ार ਚਾਰ ਸੌ ਨਵਾਸੀ
MCDXC	ਇੱਕ हज़ार ਚਾਰ ਸੌ ਨੱਬੇ
MCDXCI	ਇੱਕ हज़ार ਚਾਰ ਸੌ ਇਕਾਨਵੇਂ
MCDXCII	ਇੱਕ हज़ार ਚਾਰ ਸੌ ਬਾਨਵੇਂ
MCDXCIII	ਇੱਕ हज़ार ਚਾਰ ਸੌ ਤਰਾਨਵੇਂ
MCDXCIV	ਇੱਕ हज़ार ਚਾਰ ਸੌ ਚੁਰਾਨਵੇਂ
MCDXCV	ਇੱਕ हज़ार ਚਾਰ ਸੌ ਪਚਾਨਵੇਂ
MCDXCVI	ਇੱਕ हज़ार ਚਾਰ ਸੌ ਛਿਆਨਵੇਂ
MCDXCVII	ਇੱਕ हज़ार ਚਾਰ ਸੌ ਸਤਾਨਵੇਂ
MCDXCVIII	ਇੱਕ हज़ार ਚਾਰ ਸੌ ਅਠਾਨਵੇਂ
MCDXCIX	ਇੱਕ हज़ार ਚਾਰ ਸੌ ਨਿਨਾਨਵੇਂ
MD	ਇੱਕ हज़ार ਪੰਜ ਸੌ
MDI	ਇੱਕ हज़ार ਪੰਜ ਸੌ ਇੱਕ
MDII	ਇੱਕ हज़ार ਪੰਜ ਸੌ ਦੋ
MDIII	ਇੱਕ हज़ार ਪੰਜ ਸੌ ਤਿੰਨ
MDIV	ਇੱਕ हज़ार ਪੰਜ ਸੌ ਚਾਰ
MDV	ਇੱਕ हज़ार ਪੰਜ ਸੌ ਪੰਜ
MDVI	ਇੱਕ हज़ार ਪੰਜ ਸੌ ਛੇ
MDVII	ਇੱਕ हज़ार ਪੰਜ ਸੌ ਸੱਤ
MDVIII	ਇੱਕ हज़ार ਪੰਜ ਸੌ ਅੱਠ
MDIX	ਇੱਕ हज़ार ਪੰਜ ਸੌ ਨੌਂ
MDX	ਇੱਕ हज़ार ਪੰਜ ਸੌ ਦਸ
MDXI	ਇੱਕ हज़ार ਪੰਜ ਸੌ ਗਿਆਰਾਂ
MDXII	ਇੱਕ हज़ार ਪੰਜ ਸੌ ਬਾਰਾਂ
MDXIII	ਇੱਕ हज़ार ਪੰਜ ਸੌ ਤੇਰਾਂ
MDXIV	ਇੱਕ हज़ार ਪੰਜ ਸੌ ਚੌਦਾਂ
MDXV	ਇੱਕ हज़ार ਪੰਜ ਸੌ ਪੰਦਰਾਂ
MDXVI	ਇੱਕ हज़ार ਪੰਜ ਸੌ ਸੋਲਾਂ
MDXVII	ਇੱਕ हज़ार ਪੰਜ ਸੌ ਸਤਾਰਾਂ
MDXVIII	ਇੱਕ हज़ार ਪੰਜ ਸੌ ਅਠਾਰਾਂ
MDXIX	ਇੱਕ हज़ार ਪੰਜ ਸੌ ਉੱਨੀ
MDXX	ਇੱਕ हज़ार ਪੰਜ ਸੌ ਵੀਹ
MDXXI	ਇੱਕ हज़ार ਪੰਜ ਸੌ ਇੱਕੀ
MDXXII	ਇੱਕ हज़ार ਪੰਜ ਸੌ ਬਾਈ
MDXXIII	ਇੱਕ हज़ार ਪੰਜ ਸੌ ਤੇਈ
MDXXIV	ਇੱਕ हज़ार ਪੰਜ ਸੌ ਚੌਬੀ
MDXXV	ਇੱਕ हज़ार ਪੰਜ ਸੌ ਪੱਚੀ
MDXXVI	ਇੱਕ हज़ार ਪੰਜ ਸੌ ਛੱਬੀ
MDXXVII	ਇੱਕ हज़ार ਪੰਜ ਸੌ ਸਤਾਈ
MDXXVIII	ਇੱਕ हज़ार ਪੰਜ ਸੌ ਅਠਾਈ
MDXXIX	ਇੱਕ हज़ार ਪੰਜ ਸੌ ਉਨੱਤੀ
MDXXX	ਇੱਕ हज़ार ਪੰਜ ਸੌ ਤੀਹ
MDXXXI	ਇੱਕ हज़ार ਪੰਜ ਸੌ ਇਕੱਤੀ
MDXXXII	ਇੱਕ हज़ार ਪੰਜ ਸੌ ਬੱਤੀ
MDXXXIII	ਇੱਕ हज़ार ਪੰਜ ਸੌ ਤੇਤੀ
MDXXXIV	ਇੱਕ हज़ार ਪੰਜ ਸੌ ਚੌਂਤੀ
MDXXXV	ਇੱਕ हज़ार ਪੰਜ ਸੌ ਪੈਂਤੀ
MDXXXVI	ਇੱਕ हज़ार ਪੰਜ ਸੌ ਛੱਤੀ
MDXXXVII	ਇੱਕ हज़ार ਪੰਜ ਸੌ ਸੈਂਤੀ
MDXXXVIII	ਇੱਕ हज़ार ਪੰਜ ਸੌ ਅੜਤੀ
MDXXXIX	ਇੱਕ हज़ार ਪੰਜ ਸੌ ਉਨਤਾਲੀ
MDXL	ਇੱਕ हज़ार ਪੰਜ ਸੌ ਚਾਲੀ
MDXLI	ਇੱਕ हज़ार ਪੰਜ ਸੌ ਇਕਤਾਲੀ
MDXLII	ਇੱਕ हज़ार ਪੰਜ ਸੌ ਬਿਆਲੀ
MDXLIII	ਇੱਕ हज़ार ਪੰਜ ਸੌ ਤਰਤਾਲੀ
MDXLIV	ਇੱਕ हज़ार ਪੰਜ ਸੌ ਚਵਾਲੀ
MDXLV	ਇੱਕ हज़ार ਪੰਜ ਸੌ ਪੈਂਤਾਲੀ
MDXLVI	ਇੱਕ हज़ार ਪੰਜ ਸੌ ਛਿਆਲੀ
MDXLVII	ਇੱਕ हज़ार ਪੰਜ ਸੌ ਸੈਂਤਾਲੀ
MDXLVIII	ਇੱਕ हज़ार ਪੰਜ ਸੌ ਅੜਤਾਲੀ
MDXLIX	ਇੱਕ हज़ार ਪੰਜ ਸੌ ਉਨੰਜਾ
MDL	ਇੱਕ हज़ार ਪੰਜ ਸੌ ਪੰਜਾਹ
MDLI	ਇੱਕ हज़ार ਪੰਜ ਸੌ ਇਕਵੰਜਾ
MDLII	ਇੱਕ हज़ार ਪੰਜ ਸੌ ਬਵੰਜਾ
MDLIII	ਇੱਕ हज़ार ਪੰਜ ਸੌ ਤਰਵੰਜਾ
MDLIV	ਇੱਕ हज़ार ਪੰਜ ਸੌ ਚੁਰੰਜਾ
MDLV	ਇੱਕ हज़ार ਪੰਜ ਸੌ ਪਚਵੰਜਾ
MDLVI	ਇੱਕ हज़ार ਪੰਜ ਸੌ ਛਪੰਜਾ
MDLVII	ਇੱਕ हज़ार ਪੰਜ ਸੌ ਸਤਵੰਜਾ
MDLVIII	ਇੱਕ हज़ार ਪੰਜ ਸੌ ਅਠਵੰਜਾ
MDLIX	ਇੱਕ हज़ार ਪੰਜ ਸੌ ਉਨੱਠ
MDLX	ਇੱਕ हज़ार ਪੰਜ ਸੌ ਸੱਠ
MDLXI	ਇੱਕ हज़ार ਪੰਜ ਸੌ ਇਕਠ
MDLXII	ਇੱਕ हज़ार ਪੰਜ ਸੌ ਬਾਠ
MDLXIII	ਇੱਕ हज़ार ਪੰਜ ਸੌ ਤਰੇਠ
MDLXIV	ਇੱਕ हज़ार ਪੰਜ ਸੌ ਚੌਂਠ
MDLXV	ਇੱਕ हज़ार ਪੰਜ ਸੌ ਪੈਂਠ
MDLXVI	ਇੱਕ हज़ार ਪੰਜ ਸੌ ਛਿਆਠ
MDLXVII	ਇੱਕ हज़ार ਪੰਜ ਸੌ ਸਤੱਠ
MDLXVIII	ਇੱਕ हज़ार ਪੰਜ ਸੌ ਅਠੱਠ
MDLXIX	ਇੱਕ हज़ार ਪੰਜ ਸੌ ਉਨੱਤਰ
MDLXX	ਇੱਕ हज़ार ਪੰਜ ਸੌ ਸੱਤਰ
MDLXXI	ਇੱਕ हज़ार ਪੰਜ ਸੌ ਇਕੱਤਰ
MDLXXII	ਇੱਕ हज़ार ਪੰਜ ਸੌ ਬਹੱਤਰ
MDLXXIII	ਇੱਕ हज़ार ਪੰਜ ਸੌ ਤਿਹੱਤਰ
MDLXXIV	ਇੱਕ हज़ार ਪੰਜ ਸੌ ਚੁਹੱਤਰ
MDLXXV	ਇੱਕ हज़ार ਪੰਜ ਸੌ ਪੰਝੱਤਰ
MDLXXVI	ਇੱਕ हज़ार ਪੰਜ ਸੌ ਛਿਹੱਤਰ
MDLXXVII	ਇੱਕ हज़ार ਪੰਜ ਸੌ ਸਤੱਤਰ
MDLXXVIII	ਇੱਕ हज़ार ਪੰਜ ਸੌ ਅਠੱਤਰ
MDLXXIX	ਇੱਕ हज़ार ਪੰਜ ਸੌ ਉਨਾਸੀ
MDLXXX	ਇੱਕ हज़ार ਪੰਜ ਸੌ ਅੱਸੀ
MDLXXXI	ਇੱਕ हज़ार ਪੰਜ ਸੌ ਇਕਾਸੀ
MDLXXXII	ਇੱਕ हज़ार ਪੰਜ ਸੌ ਬਿਆਸੀ
MDLXXXIII	ਇੱਕ हज़ार ਪੰਜ ਸੌ ਤਿਰਾਸੀ
MDLXXXIV	ਇੱਕ हज़ार ਪੰਜ ਸੌ ਚੁਰਾਸੀ
MDLXXXV	ਇੱਕ हज़ार ਪੰਜ ਸੌ ਪਚਾਸੀ
MDLXXXVI	ਇੱਕ हज़ार ਪੰਜ ਸੌ ਛਿਆਸੀ
MDLXXXVII	ਇੱਕ हज़ार ਪੰਜ ਸੌ ਸਤਾਸੀ
MDLXXXVIII	ਇੱਕ हज़ार ਪੰਜ ਸੌ ਅਠਾਸੀ
MDLXXXIX	ਇੱਕ हज़ार ਪੰਜ ਸੌ ਨਵਾਸੀ
MDXC	ਇੱਕ हज़ार ਪੰਜ ਸੌ ਨੱਬੇ
MDXCI	ਇੱਕ हज़ार ਪੰਜ ਸੌ ਇਕਾਨਵੇਂ
MDXCII	ਇੱਕ हज़ार ਪੰਜ ਸੌ ਬਾਨਵੇਂ
MDXCIII	ਇੱਕ हज़ार ਪੰਜ ਸੌ ਤਰਾਨਵੇਂ
MDXCIV	ਇੱਕ हज़ार ਪੰਜ ਸੌ ਚੁਰਾਨਵੇਂ
MDXCV	ਇੱਕ हज़ार ਪੰਜ ਸੌ ਪਚਾਨਵੇਂ
MDXCVI	ਇੱਕ हज़ार ਪੰਜ ਸੌ ਛਿਆਨਵੇਂ
MDXCVII	ਇੱਕ हज़ार ਪੰਜ ਸੌ ਸਤਾਨਵੇਂ
MDXCVIII	ਇੱਕ हज़ार ਪੰਜ ਸੌ ਅਠਾਨਵੇਂ
MDXCIX	ਇੱਕ हज़ार ਪੰਜ ਸੌ ਨਿਨਾਨਵੇਂ
MDC	ਇੱਕ हज़ार ਛੇ ਸੌ
MDCI	ਇੱਕ हज़ार ਛੇ ਸੌ ਇੱਕ
MDCII	ਇੱਕ हज़ार ਛੇ ਸੌ ਦੋ
MDCIII	ਇੱਕ हज़ार ਛੇ ਸੌ ਤਿੰਨ
MDCIV	ਇੱਕ हज़ार ਛੇ ਸੌ ਚਾਰ
MDCV	ਇੱਕ हज़ार ਛੇ ਸੌ ਪੰਜ
MDCVI	ਇੱਕ हज़ार ਛੇ ਸੌ ਛੇ
MDCVII	ਇੱਕ हज़ार ਛੇ ਸੌ ਸੱਤ
MDCVIII	ਇੱਕ हज़ार ਛੇ ਸੌ ਅੱਠ
MDCIX	ਇੱਕ हज़ार ਛੇ ਸੌ ਨੌਂ
MDCX	ਇੱਕ हज़ार ਛੇ ਸੌ ਦਸ
MDCXI	ਇੱਕ हज़ार ਛੇ ਸੌ ਗਿਆਰਾਂ
MDCXII	ਇੱਕ हज़ार ਛੇ ਸੌ ਬਾਰਾਂ
MDCXIII	ਇੱਕ हज़ार ਛੇ ਸੌ ਤੇਰਾਂ
MDCXIV	ਇੱਕ हज़ार ਛੇ ਸੌ ਚੌਦਾਂ
MDCXV	ਇੱਕ हज़ार ਛੇ ਸੌ ਪੰਦਰਾਂ
MDCXVI	ਇੱਕ हज़ार ਛੇ ਸੌ ਸੋਲਾਂ
MDCXVII	ਇੱਕ हज़ार ਛੇ ਸੌ ਸਤਾਰਾਂ
MDCXVIII	ਇੱਕ हज़ार ਛੇ ਸੌ ਅਠਾਰਾਂ
MDCXIX	ਇੱਕ हज़ार ਛੇ ਸੌ ਉੱਨੀ
MDCXX	ਇੱਕ हज़ार ਛੇ ਸੌ ਵੀਹ
MDCXXI	ਇੱਕ हज़ार ਛੇ ਸੌ ਇੱਕੀ
MDCXXII	ਇੱਕ हज़ार ਛੇ ਸੌ ਬਾਈ
MDCXXIII	ਇੱਕ हज़ार ਛੇ ਸੌ ਤੇਈ
MDCXXIV	ਇੱਕ हज़ार ਛੇ ਸੌ ਚੌਬੀ
MDCXXV	ਇੱਕ हज़ार ਛੇ ਸੌ ਪੱਚੀ
MDCXXVI	ਇੱਕ हज़ार ਛੇ ਸੌ ਛੱਬੀ
MDCXXVII	ਇੱਕ हज़ार ਛੇ ਸੌ ਸਤਾਈ
MDCXXVIII	ਇੱਕ हज़ार ਛੇ ਸੌ ਅਠਾਈ
MDCXXIX	ਇੱਕ हज़ार ਛੇ ਸੌ ਉਨੱਤੀ
MDCXXX	ਇੱਕ हज़ार ਛੇ ਸੌ ਤੀਹ
MDCXXXI	ਇੱਕ हज़ार ਛੇ ਸੌ ਇਕੱਤੀ
MDCXXXII	ਇੱਕ हज़ार ਛੇ ਸੌ ਬੱਤੀ
MDCXXXIII	ਇੱਕ हज़ार ਛੇ ਸੌ ਤੇਤੀ
MDCXXXIV	ਇੱਕ हज़ार ਛੇ ਸੌ ਚੌਂਤੀ
MDCXXXV	ਇੱਕ हज़ार ਛੇ ਸੌ ਪੈਂਤੀ
MDCXXXVI	ਇੱਕ हज़ार ਛੇ ਸੌ ਛੱਤੀ
MDCXXXVII	ਇੱਕ हज़ार ਛੇ ਸੌ ਸੈਂਤੀ
MDCXXXVIII	ਇੱਕ हज़ार ਛੇ ਸੌ ਅੜਤੀ
MDCXXXIX	ਇੱਕ हज़ार ਛੇ ਸੌ ਉਨਤਾਲੀ
MDCXL	ਇੱਕ हज़ार ਛੇ ਸੌ ਚਾਲੀ
MDCXLI	ਇੱਕ हज़ार ਛੇ ਸੌ ਇਕਤਾਲੀ
MDCXLII	ਇੱਕ हज़ार ਛੇ ਸੌ ਬਿਆਲੀ
MDCXLIII	ਇੱਕ हज़ार ਛੇ ਸੌ ਤਰਤਾਲੀ
MDCXLIV	ਇੱਕ हज़ार ਛੇ ਸੌ ਚਵਾਲੀ
MDCXLV	ਇੱਕ हज़ार ਛੇ ਸੌ ਪੈਂਤਾਲੀ
MDCXLVI	ਇੱਕ हज़ार ਛੇ ਸੌ ਛਿਆਲੀ
MDCXLVII	ਇੱਕ हज़ार ਛੇ ਸੌ ਸੈਂਤਾਲੀ
MDCXLVIII	ਇੱਕ हज़ार ਛੇ ਸੌ ਅੜਤਾਲੀ
MDCXLIX	ਇੱਕ हज़ार ਛੇ ਸੌ ਉਨੰਜਾ
MDCL	ਇੱਕ हज़ार ਛੇ ਸੌ ਪੰਜਾਹ
MDCLI	ਇੱਕ हज़ार ਛੇ ਸੌ ਇਕਵੰਜਾ
MDCLII	ਇੱਕ हज़ार ਛੇ ਸੌ ਬਵੰਜਾ
MDCLIII	ਇੱਕ हज़ार ਛੇ ਸੌ ਤਰਵੰਜਾ
MDCLIV	ਇੱਕ हज़ार ਛੇ ਸੌ ਚੁਰੰਜਾ
MDCLV	ਇੱਕ हज़ार ਛੇ ਸੌ ਪਚਵੰਜਾ
MDCLVI	ਇੱਕ हज़ार ਛੇ ਸੌ ਛਪੰਜਾ
MDCLVII	ਇੱਕ हज़ार ਛੇ ਸੌ ਸਤਵੰਜਾ
MDCLVIII	ਇੱਕ हज़ार ਛੇ ਸੌ ਅਠਵੰਜਾ
MDCLIX	ਇੱਕ हज़ार ਛੇ ਸੌ ਉਨੱਠ
MDCLX	ਇੱਕ हज़ार ਛੇ ਸੌ ਸੱਠ
MDCLXI	ਇੱਕ हज़ार ਛੇ ਸੌ ਇਕਠ
MDCLXII	ਇੱਕ हज़ार ਛੇ ਸੌ ਬਾਠ
MDCLXIII	ਇੱਕ हज़ार ਛੇ ਸੌ ਤਰੇਠ
MDCLXIV	ਇੱਕ हज़ार ਛੇ ਸੌ ਚੌਂਠ
MDCLXV	ਇੱਕ हज़ार ਛੇ ਸੌ ਪੈਂਠ
MDCLXVI	ਇੱਕ हज़ार ਛੇ ਸੌ ਛਿਆਠ
MDCLXVII	ਇੱਕ हज़ार ਛੇ ਸੌ ਸਤੱਠ
MDCLXVIII	ਇੱਕ हज़ार ਛੇ ਸੌ ਅਠੱਠ
MDCLXIX	ਇੱਕ हज़ार ਛੇ ਸੌ ਉਨੱਤਰ
MDCLXX	ਇੱਕ हज़ार ਛੇ ਸੌ ਸੱਤਰ
MDCLXXI	ਇੱਕ हज़ार ਛੇ ਸੌ ਇਕੱਤਰ
MDCLXXII	ਇੱਕ हज़ार ਛੇ ਸੌ ਬਹੱਤਰ
MDCLXXIII	ਇੱਕ हज़ार ਛੇ ਸੌ ਤਿਹੱਤਰ
MDCLXXIV	ਇੱਕ हज़ार ਛੇ ਸੌ ਚੁਹੱਤਰ
MDCLXXV	ਇੱਕ हज़ार ਛੇ ਸੌ ਪੰਝੱਤਰ
MDCLXXVI	ਇੱਕ हज़ार ਛੇ ਸੌ ਛਿਹੱਤਰ
MDCLXXVII	ਇੱਕ हज़ार ਛੇ ਸੌ ਸਤੱਤਰ
MDCLXXVIII	ਇੱਕ हज़ार ਛੇ ਸੌ ਅਠੱਤਰ
MDCLXXIX	ਇੱਕ हज़ार ਛੇ ਸੌ ਉਨਾਸੀ
MDCLXXX	ਇੱਕ हज़ार ਛੇ ਸੌ ਅੱਸੀ
MDCLXXXI	ਇੱਕ हज़ार ਛੇ ਸੌ ਇਕਾਸੀ
MDCLXXXII	ਇੱਕ हज़ार ਛੇ ਸੌ ਬਿਆਸੀ
MDCLXXXIII	ਇੱਕ हज़ार ਛੇ ਸੌ ਤਿਰਾਸੀ
MDCLXXXIV	ਇੱਕ हज़ार ਛੇ ਸੌ ਚੁਰਾਸੀ
MDCLXXXV	ਇੱਕ हज़ार ਛੇ ਸੌ ਪਚਾਸੀ
MDCLXXXVI	ਇੱਕ हज़ार ਛੇ ਸੌ ਛਿਆਸੀ
MDCLXXXVII	ਇੱਕ हज़ार ਛੇ ਸੌ ਸਤਾਸੀ
MDCLXXXVIII	ਇੱਕ हज़ार ਛੇ ਸੌ ਅਠਾਸੀ
MDCLXXXIX	ਇੱਕ हज़ार ਛੇ ਸੌ ਨਵਾਸੀ
MDCXC	ਇੱਕ हज़ार ਛੇ ਸੌ ਨੱਬੇ
MDCXCI	ਇੱਕ हज़ार ਛੇ ਸੌ ਇਕਾਨਵੇਂ
MDCXCII	ਇੱਕ हज़ार ਛੇ ਸੌ ਬਾਨਵੇਂ
MDCXCIII	ਇੱਕ हज़ार ਛੇ ਸੌ ਤਰਾਨਵੇਂ
MDCXCIV	ਇੱਕ हज़ार ਛੇ ਸੌ ਚੁਰਾਨਵੇਂ
MDCXCV	ਇੱਕ हज़ार ਛੇ ਸੌ ਪਚਾਨਵੇਂ
MDCXCVI	ਇੱਕ हज़ार ਛੇ ਸੌ ਛਿਆਨਵੇਂ
MDCXCVII	ਇੱਕ हज़ार ਛੇ ਸੌ ਸਤਾਨਵੇਂ
MDCXCVIII	ਇੱਕ हज़ार ਛੇ ਸੌ ਅਠਾਨਵੇਂ
MDCXCIX	ਇੱਕ हज़ार ਛੇ ਸੌ ਨਿਨਾਨਵੇਂ
MDCC	ਇੱਕ हज़ार ਸੱਤ ਸੌ
MDCCI	ਇੱਕ हज़ार ਸੱਤ ਸੌ ਇੱਕ
MDCCII	ਇੱਕ हज़ार ਸੱਤ ਸੌ ਦੋ
MDCCIII	ਇੱਕ हज़ार ਸੱਤ ਸੌ ਤਿੰਨ
MDCCIV	ਇੱਕ हज़ार ਸੱਤ ਸੌ ਚਾਰ
MDCCV	ਇੱਕ हज़ार ਸੱਤ ਸੌ ਪੰਜ
MDCCVI	ਇੱਕ हज़ार ਸੱਤ ਸੌ ਛੇ
MDCCVII	ਇੱਕ हज़ार ਸੱਤ ਸੌ ਸੱਤ
MDCCVIII	ਇੱਕ हज़ार ਸੱਤ ਸੌ ਅੱਠ
MDCCIX	ਇੱਕ हज़ार ਸੱਤ ਸੌ ਨੌਂ
MDCCX	ਇੱਕ हज़ार ਸੱਤ ਸੌ ਦਸ
MDCCXI	ਇੱਕ हज़ार ਸੱਤ ਸੌ ਗਿਆਰਾਂ
MDCCXII	ਇੱਕ हज़ार ਸੱਤ ਸੌ ਬਾਰਾਂ
MDCCXIII	ਇੱਕ हज़ार ਸੱਤ ਸੌ ਤੇਰਾਂ
MDCCXIV	ਇੱਕ हज़ार ਸੱਤ ਸੌ ਚੌਦਾਂ
MDCCXV	ਇੱਕ हज़ार ਸੱਤ ਸੌ ਪੰਦਰਾਂ
MDCCXVI	ਇੱਕ हज़ार ਸੱਤ ਸੌ ਸੋਲਾਂ
MDCCXVII	ਇੱਕ हज़ार ਸੱਤ ਸੌ ਸਤਾਰਾਂ
MDCCXVIII	ਇੱਕ हज़ार ਸੱਤ ਸੌ ਅਠਾਰਾਂ
MDCCXIX	ਇੱਕ हज़ार ਸੱਤ ਸੌ ਉੱਨੀ
MDCCXX	ਇੱਕ हज़ार ਸੱਤ ਸੌ ਵੀਹ
MDCCXXI	ਇੱਕ हज़ार ਸੱਤ ਸੌ ਇੱਕੀ
MDCCXXII	ਇੱਕ हज़ार ਸੱਤ ਸੌ ਬਾਈ
MDCCXXIII	ਇੱਕ हज़ार ਸੱਤ ਸੌ ਤੇਈ
MDCCXXIV	ਇੱਕ हज़ार ਸੱਤ ਸੌ ਚੌਬੀ
MDCCXXV	ਇੱਕ हज़ार ਸੱਤ ਸੌ ਪੱਚੀ
MDCCXXVI	ਇੱਕ हज़ार ਸੱਤ ਸੌ ਛੱਬੀ
MDCCXXVII	ਇੱਕ हज़ार ਸੱਤ ਸੌ ਸਤਾਈ
MDCCXXVIII	ਇੱਕ हज़ार ਸੱਤ ਸੌ ਅਠਾਈ
MDCCXXIX	ਇੱਕ हज़ार ਸੱਤ ਸੌ ਉਨੱਤੀ
MDCCXXX	ਇੱਕ हज़ार ਸੱਤ ਸੌ ਤੀਹ
MDCCXXXI	ਇੱਕ हज़ार ਸੱਤ ਸੌ ਇਕੱਤੀ
MDCCXXXII	ਇੱਕ हज़ार ਸੱਤ ਸੌ ਬੱਤੀ
MDCCXXXIII	ਇੱਕ हज़ार ਸੱਤ ਸੌ ਤੇਤੀ
MDCCXXXIV	ਇੱਕ हज़ार ਸੱਤ ਸੌ ਚੌਂਤੀ
MDCCXXXV	ਇੱਕ हज़ार ਸੱਤ ਸੌ ਪੈਂਤੀ
MDCCXXXVI	ਇੱਕ हज़ार ਸੱਤ ਸੌ ਛੱਤੀ
MDCCXXXVII	ਇੱਕ हज़ार ਸੱਤ ਸੌ ਸੈਂਤੀ
MDCCXXXVIII	ਇੱਕ हज़ार ਸੱਤ ਸੌ ਅੜਤੀ
MDCCXXXIX	ਇੱਕ हज़ार ਸੱਤ ਸੌ ਉਨਤਾਲੀ
MDCCXL	ਇੱਕ हज़ार ਸੱਤ ਸੌ ਚਾਲੀ
MDCCXLI	ਇੱਕ हज़ार ਸੱਤ ਸੌ ਇਕਤਾਲੀ
MDCCXLII	ਇੱਕ हज़ार ਸੱਤ ਸੌ ਬਿਆਲੀ
MDCCXLIII	ਇੱਕ हज़ार ਸੱਤ ਸੌ ਤਰਤਾਲੀ
MDCCXLIV	ਇੱਕ हज़ार ਸੱਤ ਸੌ ਚਵਾਲੀ
MDCCXLV	ਇੱਕ हज़ार ਸੱਤ ਸੌ ਪੈਂਤਾਲੀ
MDCCXLVI	ਇੱਕ हज़ार ਸੱਤ ਸੌ ਛਿਆਲੀ
MDCCXLVII	ਇੱਕ हज़ार ਸੱਤ ਸੌ ਸੈਂਤਾਲੀ
MDCCXLVIII	ਇੱਕ हज़ार ਸੱਤ ਸੌ ਅੜਤਾਲੀ
MDCCXLIX	ਇੱਕ हज़ार ਸੱਤ ਸੌ ਉਨੰਜਾ
MDCCL	ਇੱਕ हज़ार ਸੱਤ ਸੌ ਪੰਜਾਹ
MDCCLI	ਇੱਕ हज़ार ਸੱਤ ਸੌ ਇਕਵੰਜਾ
MDCCLII	ਇੱਕ हज़ार ਸੱਤ ਸੌ ਬਵੰਜਾ
MDCCLIII	ਇੱਕ हज़ार ਸੱਤ ਸੌ ਤਰਵੰਜਾ
MDCCLIV	ਇੱਕ हज़ार ਸੱਤ ਸੌ ਚੁਰੰਜਾ
MDCCLV	ਇੱਕ हज़ार ਸੱਤ ਸੌ ਪਚਵੰਜਾ
MDCCLVI	ਇੱਕ हज़ार ਸੱਤ ਸੌ ਛਪੰਜਾ
MDCCLVII	ਇੱਕ हज़ार ਸੱਤ ਸੌ ਸਤਵੰਜਾ
MDCCLVIII	ਇੱਕ हज़ार ਸੱਤ ਸੌ ਅਠਵੰਜਾ
MDCCLIX	ਇੱਕ हज़ार ਸੱਤ ਸੌ ਉਨੱਠ
MDCCLX	ਇੱਕ हज़ार ਸੱਤ ਸੌ ਸੱਠ
MDCCLXI	ਇੱਕ हज़ार ਸੱਤ ਸੌ ਇਕਠ
MDCCLXII	ਇੱਕ हज़ार ਸੱਤ ਸੌ ਬਾਠ
MDCCLXIII	ਇੱਕ हज़ार ਸੱਤ ਸੌ ਤਰੇਠ
MDCCLXIV	ਇੱਕ हज़ार ਸੱਤ ਸੌ ਚੌਂਠ
MDCCLXV	ਇੱਕ हज़ार ਸੱਤ ਸੌ ਪੈਂਠ
MDCCLXVI	ਇੱਕ हज़ार ਸੱਤ ਸੌ ਛਿਆਠ
MDCCLXVII	ਇੱਕ हज़ार ਸੱਤ ਸੌ ਸਤੱਠ
MDCCLXVIII	ਇੱਕ हज़ार ਸੱਤ ਸੌ ਅਠੱਠ
MDCCLXIX	ਇੱਕ हज़ार ਸੱਤ ਸੌ ਉਨੱਤਰ
MDCCLXX	ਇੱਕ हज़ार ਸੱਤ ਸੌ ਸੱਤਰ
MDCCLXXI	ਇੱਕ हज़ार ਸੱਤ ਸੌ ਇਕੱਤਰ
MDCCLXXII	ਇੱਕ हज़ार ਸੱਤ ਸੌ ਬਹੱਤਰ
MDCCLXXIII	ਇੱਕ हज़ार ਸੱਤ ਸੌ ਤਿਹੱਤਰ
MDCCLXXIV	ਇੱਕ हज़ार ਸੱਤ ਸੌ ਚੁਹੱਤਰ
MDCCLXXV	ਇੱਕ हज़ार ਸੱਤ ਸੌ ਪੰਝੱਤਰ
MDCCLXXVI	ਇੱਕ हज़ार ਸੱਤ ਸੌ ਛਿਹੱਤਰ
MDCCLXXVII	ਇੱਕ हज़ार ਸੱਤ ਸੌ ਸਤੱਤਰ
MDCCLXXVIII	ਇੱਕ हज़ार ਸੱਤ ਸੌ ਅਠੱਤਰ
MDCCLXXIX	ਇੱਕ हज़ार ਸੱਤ ਸੌ ਉਨਾਸੀ
MDCCLXXX	ਇੱਕ हज़ार ਸੱਤ ਸੌ ਅੱਸੀ
MDCCLXXXI	ਇੱਕ हज़ार ਸੱਤ ਸੌ ਇਕਾਸੀ
MDCCLXXXII	ਇੱਕ हज़ार ਸੱਤ ਸੌ ਬਿਆਸੀ
MDCCLXXXIII	ਇੱਕ हज़ार ਸੱਤ ਸੌ ਤਿਰਾਸੀ
MDCCLXXXIV	ਇੱਕ हज़ार ਸੱਤ ਸੌ ਚੁਰਾਸੀ
MDCCLXXXV	ਇੱਕ हज़ार ਸੱਤ ਸੌ ਪਚਾਸੀ
MDCCLXXXVI	ਇੱਕ हज़ार ਸੱਤ ਸੌ ਛਿਆਸੀ
MDCCLXXXVII	ਇੱਕ हज़ार ਸੱਤ ਸੌ ਸਤਾਸੀ
MDCCLXXXVIII	ਇੱਕ हज़ार ਸੱਤ ਸੌ ਅਠਾਸੀ
MDCCLXXXIX	ਇੱਕ हज़ार ਸੱਤ ਸੌ ਨਵਾਸੀ
MDCCXC	ਇੱਕ हज़ार ਸੱਤ ਸੌ ਨੱਬੇ
MDCCXCI	ਇੱਕ हज़ार ਸੱਤ ਸੌ ਇਕਾਨਵੇਂ
MDCCXCII	ਇੱਕ हज़ार ਸੱਤ ਸੌ ਬਾਨਵੇਂ
MDCCXCIII	ਇੱਕ हज़ार ਸੱਤ ਸੌ ਤਰਾਨਵੇਂ
MDCCXCIV	ਇੱਕ हज़ार ਸੱਤ ਸੌ ਚੁਰਾਨਵੇਂ
MDCCXCV	ਇੱਕ हज़ार ਸੱਤ ਸੌ ਪਚਾਨਵੇਂ
MDCCXCVI	ਇੱਕ हज़ार ਸੱਤ ਸੌ ਛਿਆਨਵੇਂ
MDCCXCVII	ਇੱਕ हज़ार ਸੱਤ ਸੌ ਸਤਾਨਵੇਂ
MDCCXCVIII	ਇੱਕ हज़ार ਸੱਤ ਸੌ ਅਠਾਨਵੇਂ
MDCCXCIX	ਇੱਕ हज़ार ਸੱਤ ਸੌ ਨਿਨਾਨਵੇਂ
MDCCC	ਇੱਕ हज़ार ਅੱਠ ਸੌ
MDCCCI	ਇੱਕ हज़ार ਅੱਠ ਸੌ ਇੱਕ
MDCCCII	ਇੱਕ हज़ार ਅੱਠ ਸੌ ਦੋ
MDCCCIII	ਇੱਕ हज़ार ਅੱਠ ਸੌ ਤਿੰਨ
MDCCCIV	ਇੱਕ हज़ार ਅੱਠ ਸੌ ਚਾਰ
MDCCCV	ਇੱਕ हज़ार ਅੱਠ ਸੌ ਪੰਜ
MDCCCVI	ਇੱਕ हज़ार ਅੱਠ ਸੌ ਛੇ
MDCCCVII	ਇੱਕ हज़ार ਅੱਠ ਸੌ ਸੱਤ
MDCCCVIII	ਇੱਕ हज़ार ਅੱਠ ਸੌ ਅੱਠ
MDCCCIX	ਇੱਕ हज़ार ਅੱਠ ਸੌ ਨੌਂ
MDCCCX	ਇੱਕ हज़ार ਅੱਠ ਸੌ ਦਸ
MDCCCXI	ਇੱਕ हज़ार ਅੱਠ ਸੌ ਗਿਆਰਾਂ
MDCCCXII	ਇੱਕ हज़ार ਅੱਠ ਸੌ ਬਾਰਾਂ
MDCCCXIII	ਇੱਕ हज़ार ਅੱਠ ਸੌ ਤੇਰਾਂ
MDCCCXIV	ਇੱਕ हज़ार ਅੱਠ ਸੌ ਚੌਦਾਂ
MDCCCXV	ਇੱਕ हज़ार ਅੱਠ ਸੌ ਪੰਦਰਾਂ
MDCCCXVI	ਇੱਕ हज़ार ਅੱਠ ਸੌ ਸੋਲਾਂ
MDCCCXVII	ਇੱਕ हज़ार ਅੱਠ ਸੌ ਸਤਾਰਾਂ
MDCCCXVIII	ਇੱਕ हज़ार ਅੱਠ ਸੌ ਅਠਾਰਾਂ
MDCCCXIX	ਇੱਕ हज़ार ਅੱਠ ਸੌ ਉੱਨੀ
MDCCCXX	ਇੱਕ हज़ार ਅੱਠ ਸੌ ਵੀਹ
MDCCCXXI	ਇੱਕ हज़ार ਅੱਠ ਸੌ ਇੱਕੀ
MDCCCXXII	ਇੱਕ हज़ार ਅੱਠ ਸੌ ਬਾਈ
MDCCCXXIII	ਇੱਕ हज़ार ਅੱਠ ਸੌ ਤੇਈ
MDCCCXXIV	ਇੱਕ हज़ार ਅੱਠ ਸੌ ਚੌਬੀ
MDCCCXXV	ਇੱਕ हज़ार ਅੱਠ ਸੌ ਪੱਚੀ
MDCCCXXVI	ਇੱਕ हज़ार ਅੱਠ ਸੌ ਛੱਬੀ
MDCCCXXVII	ਇੱਕ हज़ार ਅੱਠ ਸੌ ਸਤਾਈ
MDCCCXXVIII	ਇੱਕ हज़ार ਅੱਠ ਸੌ ਅਠਾਈ
MDCCCXXIX	ਇੱਕ हज़ार ਅੱਠ ਸੌ ਉਨੱਤੀ
MDCCCXXX	ਇੱਕ हज़ार ਅੱਠ ਸੌ ਤੀਹ
MDCCCXXXI	ਇੱਕ हज़ार ਅੱਠ ਸੌ ਇਕੱਤੀ
MDCCCXXXII	ਇੱਕ हज़ार ਅੱਠ ਸੌ ਬੱਤੀ
MDCCCXXXIII	ਇੱਕ हज़ार ਅੱਠ ਸੌ ਤੇਤੀ
MDCCCXXXIV	ਇੱਕ हज़ार ਅੱਠ ਸੌ ਚੌਂਤੀ
MDCCCXXXV	ਇੱਕ हज़ार ਅੱਠ ਸੌ ਪੈਂਤੀ
MDCCCXXXVI	ਇੱਕ हज़ार ਅੱਠ ਸੌ ਛੱਤੀ
MDCCCXXXVII	ਇੱਕ हज़ार ਅੱਠ ਸੌ ਸੈਂਤੀ
MDCCCXXXVIII	ਇੱਕ हज़ार ਅੱਠ ਸੌ ਅੜਤੀ
MDCCCXXXIX	ਇੱਕ हज़ार ਅੱਠ ਸੌ ਉਨਤਾਲੀ
MDCCCXL	ਇੱਕ हज़ार ਅੱਠ ਸੌ ਚਾਲੀ
MDCCCXLI	ਇੱਕ हज़ार ਅੱਠ ਸੌ ਇਕਤਾਲੀ
MDCCCXLII	ਇੱਕ हज़ार ਅੱਠ ਸੌ ਬਿਆਲੀ
MDCCCXLIII	ਇੱਕ हज़ार ਅੱਠ ਸੌ ਤਰਤਾਲੀ
MDCCCXLIV	ਇੱਕ हज़ार ਅੱਠ ਸੌ ਚਵਾਲੀ
MDCCCXLV	ਇੱਕ हज़ार ਅੱਠ ਸੌ ਪੈਂਤਾਲੀ
MDCCCXLVI	ਇੱਕ हज़ार ਅੱਠ ਸੌ ਛਿਆਲੀ
MDCCCXLVII	ਇੱਕ हज़ार ਅੱਠ ਸੌ ਸੈਂਤਾਲੀ
MDCCCXLVIII	ਇੱਕ हज़ार ਅੱਠ ਸੌ ਅੜਤਾਲੀ
MDCCCXLIX	ਇੱਕ हज़ार ਅੱਠ ਸੌ ਉਨੰਜਾ
MDCCCL	ਇੱਕ हज़ार ਅੱਠ ਸੌ ਪੰਜਾਹ
MDCCCLI	ਇੱਕ हज़ार ਅੱਠ ਸੌ ਇਕਵੰਜਾ
MDCCCLII	ਇੱਕ हज़ार ਅੱਠ ਸੌ ਬਵੰਜਾ
MDCCCLIII	ਇੱਕ हज़ार ਅੱਠ ਸੌ ਤਰਵੰਜਾ
MDCCCLIV	ਇੱਕ हज़ार ਅੱਠ ਸੌ ਚੁਰੰਜਾ
MDCCCLV	ਇੱਕ हज़ार ਅੱਠ ਸੌ ਪਚਵੰਜਾ
MDCCCLVI	ਇੱਕ हज़ार ਅੱਠ ਸੌ ਛਪੰਜਾ
MDCCCLVII	ਇੱਕ हज़ार ਅੱਠ ਸੌ ਸਤਵੰਜਾ
MDCCCLVIII	ਇੱਕ हज़ार ਅੱਠ ਸੌ ਅਠਵੰਜਾ
MDCCCLIX	ਇੱਕ हज़ार ਅੱਠ ਸੌ ਉਨੱਠ
MDCCCLX	ਇੱਕ हज़ार ਅੱਠ ਸੌ ਸੱਠ
MDCCCLXI	ਇੱਕ हज़ार ਅੱਠ ਸੌ ਇਕਠ
MDCCCLXII	ਇੱਕ हज़ार ਅੱਠ ਸੌ ਬਾਠ
MDCCCLXIII	ਇੱਕ हज़ार ਅੱਠ ਸੌ ਤਰੇਠ
MDCCCLXIV	ਇੱਕ हज़ार ਅੱਠ ਸੌ ਚੌਂਠ
MDCCCLXV	ਇੱਕ हज़ार ਅੱਠ ਸੌ ਪੈਂਠ
MDCCCLXVI	ਇੱਕ हज़ार ਅੱਠ ਸੌ ਛਿਆਠ
MDCCCLXVII	ਇੱਕ हज़ार ਅੱਠ ਸੌ ਸਤੱਠ
MDCCCLXVIII	ਇੱਕ हज़ार ਅੱਠ ਸੌ ਅਠੱਠ
MDCCCLXIX	ਇੱਕ हज़ार ਅੱਠ ਸੌ ਉਨੱਤਰ
MDCCCLXX	ਇੱਕ हज़ार ਅੱਠ ਸੌ ਸੱਤਰ
MDCCCLXXI	ਇੱਕ हज़ार ਅੱਠ ਸੌ ਇਕੱਤਰ
MDCCCLXXII	ਇੱਕ हज़ार ਅੱਠ ਸੌ ਬਹੱਤਰ
MDCCCLXXIII	ਇੱਕ हज़ार ਅੱਠ ਸੌ ਤਿਹੱਤਰ
MDCCCLXXIV	ਇੱਕ हज़ार ਅੱਠ ਸੌ ਚੁਹੱਤਰ
MDCCCLXXV	ਇੱਕ हज़ार ਅੱਠ ਸੌ ਪੰਝੱਤਰ
MDCCCLXXVI	ਇੱਕ हज़ार ਅੱਠ ਸੌ ਛਿਹੱਤਰ
MDCCCLXXVII	ਇੱਕ हज़ार ਅੱਠ ਸੌ ਸਤੱਤਰ
MDCCCLXXVIII	ਇੱਕ हज़ार ਅੱਠ ਸੌ ਅਠੱਤਰ
MDCCCLXXIX	ਇੱਕ हज़ार ਅੱਠ ਸੌ ਉਨਾਸੀ
MDCCCLXXX	ਇੱਕ हज़ार ਅੱਠ ਸੌ ਅੱਸੀ
MDCCCLXXXI	ਇੱਕ हज़ार ਅੱਠ ਸੌ ਇਕਾਸੀ
MDCCCLXXXII	ਇੱਕ हज़ार ਅੱਠ ਸੌ ਬਿਆਸੀ
MDCCCLXXXIII	ਇੱਕ हज़ार ਅੱਠ ਸੌ ਤਿਰਾਸੀ
MDCCCLXXXIV	ਇੱਕ हज़ार ਅੱਠ ਸੌ ਚੁਰਾਸੀ
MDCCCLXXXV	ਇੱਕ हज़ार ਅੱਠ ਸੌ ਪਚਾਸੀ
MDCCCLXXXVI	ਇੱਕ हज़ार ਅੱਠ ਸੌ ਛਿਆਸੀ
MDCCCLXXXVII	ਇੱਕ हज़ार ਅੱਠ ਸੌ ਸਤਾਸੀ
MDCCCLXXXVIII	ਇੱਕ हज़ार ਅੱਠ ਸੌ ਅਠਾਸੀ
MDCCCLXXXIX	ਇੱਕ हज़ार ਅੱਠ ਸੌ ਨਵਾਸੀ
MDCCCXC	ਇੱਕ हज़ार ਅੱਠ ਸੌ ਨੱਬੇ
MDCCCXCI	ਇੱਕ हज़ार ਅੱਠ ਸੌ ਇਕਾਨਵੇਂ
MDCCCXCII	ਇੱਕ हज़ार ਅੱਠ ਸੌ ਬਾਨਵੇਂ
MDCCCXCIII	ਇੱਕ हज़ार ਅੱਠ ਸੌ ਤਰਾਨਵੇਂ
MDCCCXCIV	ਇੱਕ हज़ार ਅੱਠ ਸੌ ਚੁਰਾਨਵੇਂ
MDCCCXCV	ਇੱਕ हज़ार ਅੱਠ ਸੌ ਪਚਾਨਵੇਂ
MDCCCXCVI	ਇੱਕ हज़ार ਅੱਠ ਸੌ ਛਿਆਨਵੇਂ
MDCCCXCVII	ਇੱਕ हज़ार ਅੱਠ ਸੌ ਸਤਾਨਵੇਂ
MDCCCXCVIII	ਇੱਕ हज़ार ਅੱਠ ਸੌ ਅਠਾਨਵੇਂ
MDCCCXCIX	ਇੱਕ हज़ार ਅੱਠ ਸੌ ਨਿਨਾਨਵੇਂ
MCM	ਇੱਕ हज़ार ਨੌਂ ਸੌ
MCMI	ਇੱਕ हज़ार ਨੌਂ ਸੌ ਇੱਕ
MCMII	ਇੱਕ हज़ार ਨੌਂ ਸੌ ਦੋ
MCMIII	ਇੱਕ हज़ार ਨੌਂ ਸੌ ਤਿੰਨ
MCMIV	ਇੱਕ हज़ार ਨੌਂ ਸੌ ਚਾਰ
MCMV	ਇੱਕ हज़ार ਨੌਂ ਸੌ ਪੰਜ
MCMVI	ਇੱਕ हज़ार ਨੌਂ ਸੌ ਛੇ
MCMVII	ਇੱਕ हज़ार ਨੌਂ ਸੌ ਸੱਤ
MCMVIII	ਇੱਕ हज़ार ਨੌਂ ਸੌ ਅੱਠ
MCMIX	ਇੱਕ हज़ार ਨੌਂ ਸੌ ਨੌਂ
MCMX	ਇੱਕ हज़ार ਨੌਂ ਸੌ ਦਸ
MCMXI	ਇੱਕ हज़ार ਨੌਂ ਸੌ ਗਿਆਰਾਂ
MCMXII	ਇੱਕ हज़ार ਨੌਂ ਸੌ ਬਾਰਾਂ
MCMXIII	ਇੱਕ हज़ार ਨੌਂ ਸੌ ਤੇਰਾਂ
MCMXIV	ਇੱਕ हज़ार ਨੌਂ ਸੌ ਚੌਦਾਂ
MCMXV	ਇੱਕ हज़ार ਨੌਂ ਸੌ ਪੰਦਰਾਂ
MCMXVI	ਇੱਕ हज़ार ਨੌਂ ਸੌ ਸੋਲਾਂ
MCMXVII	ਇੱਕ हज़ार ਨੌਂ ਸੌ ਸਤਾਰਾਂ
MCMXVIII	ਇੱਕ हज़ार ਨੌਂ ਸੌ ਅਠਾਰਾਂ
MCMXIX	ਇੱਕ हज़ार ਨੌਂ ਸੌ ਉੱਨੀ
MCMXX	ਇੱਕ हज़ार ਨੌਂ ਸੌ ਵੀਹ
MCMXXI	ਇੱਕ हज़ार ਨੌਂ ਸੌ ਇੱਕੀ
MCMXXII	ਇੱਕ हज़ार ਨੌਂ ਸੌ ਬਾਈ
MCMXXIII	ਇੱਕ हज़ार ਨੌਂ ਸੌ ਤੇਈ
MCMXXIV	ਇੱਕ हज़ार ਨੌਂ ਸੌ ਚੌਬੀ
MCMXXV	ਇੱਕ हज़ार ਨੌਂ ਸੌ ਪੱਚੀ
MCMXXVI	ਇੱਕ हज़ार ਨੌਂ ਸੌ ਛੱਬੀ
MCMXXVII	ਇੱਕ हज़ार ਨੌਂ ਸੌ ਸਤਾਈ
MCMXXVIII	ਇੱਕ हज़ार ਨੌਂ ਸੌ ਅਠਾਈ
MCMXXIX	ਇੱਕ हज़ार ਨੌਂ ਸੌ ਉਨੱਤੀ
MCMXXX	ਇੱਕ हज़ार ਨੌਂ ਸੌ ਤੀਹ
MCMXXXI	ਇੱਕ हज़ार ਨੌਂ ਸੌ ਇਕੱਤੀ
MCMXXXII	ਇੱਕ हज़ार ਨੌਂ ਸੌ ਬੱਤੀ
MCMXXXIII	ਇੱਕ हज़ार ਨੌਂ ਸੌ ਤੇਤੀ
MCMXXXIV	ਇੱਕ हज़ार ਨੌਂ ਸੌ ਚੌਂਤੀ
MCMXXXV	ਇੱਕ हज़ार ਨੌਂ ਸੌ ਪੈਂਤੀ
MCMXXXVI	ਇੱਕ हज़ार ਨੌਂ ਸੌ ਛੱਤੀ
MCMXXXVII	ਇੱਕ हज़ार ਨੌਂ ਸੌ ਸੈਂਤੀ
MCMXXXVIII	ਇੱਕ हज़ार ਨੌਂ ਸੌ ਅੜਤੀ
MCMXXXIX	ਇੱਕ हज़ार ਨੌਂ ਸੌ ਉਨਤਾਲੀ
MCMXL	ਇੱਕ हज़ार ਨੌਂ ਸੌ ਚਾਲੀ
MCMXLI	ਇੱਕ हज़ार ਨੌਂ ਸੌ ਇਕਤਾਲੀ
MCMXLII	ਇੱਕ हज़ार ਨੌਂ ਸੌ ਬਿਆਲੀ
MCMXLIII	ਇੱਕ हज़ार ਨੌਂ ਸੌ ਤਰਤਾਲੀ
MCMXLIV	ਇੱਕ हज़ार ਨੌਂ ਸੌ ਚਵਾਲੀ
MCMXLV	ਇੱਕ हज़ार ਨੌਂ ਸੌ ਪੈਂਤਾਲੀ
MCMXLVI	ਇੱਕ हज़ार ਨੌਂ ਸੌ ਛਿਆਲੀ
MCMXLVII	ਇੱਕ हज़ार ਨੌਂ ਸੌ ਸੈਂਤਾਲੀ
MCMXLVIII	ਇੱਕ हज़ार ਨੌਂ ਸੌ ਅੜਤਾਲੀ
MCMXLIX	ਇੱਕ हज़ार ਨੌਂ ਸੌ ਉਨੰਜਾ
MCML	ਇੱਕ हज़ार ਨੌਂ ਸੌ ਪੰਜਾਹ
MCMLI	ਇੱਕ हज़ार ਨੌਂ ਸੌ ਇਕਵੰਜਾ
MCMLII	ਇੱਕ हज़ार ਨੌਂ ਸੌ ਬਵੰਜਾ
MCMLIII	ਇੱਕ हज़ार ਨੌਂ ਸੌ ਤਰਵੰਜਾ
MCMLIV	ਇੱਕ हज़ार ਨੌਂ ਸੌ ਚੁਰੰਜਾ
MCMLV	ਇੱਕ हज़ार ਨੌਂ ਸੌ ਪਚਵੰਜਾ
MCMLVI	ਇੱਕ हज़ार ਨੌਂ ਸੌ ਛਪੰਜਾ
MCMLVII	ਇੱਕ हज़ार ਨੌਂ ਸੌ ਸਤਵੰਜਾ
MCMLVIII	ਇੱਕ हज़ार ਨੌਂ ਸੌ ਅਠਵੰਜਾ
MCMLIX	ਇੱਕ हज़ार ਨੌਂ ਸੌ ਉਨੱਠ
MCMLX	ਇੱਕ हज़ार ਨੌਂ ਸੌ ਸੱਠ
MCMLXI	ਇੱਕ हज़ार ਨੌਂ ਸੌ ਇਕਠ
MCMLXII	ਇੱਕ हज़ार ਨੌਂ ਸੌ ਬਾਠ
MCMLXIII	ਇੱਕ हज़ार ਨੌਂ ਸੌ ਤਰੇਠ
MCMLXIV	ਇੱਕ हज़ार ਨੌਂ ਸੌ ਚੌਂਠ
MCMLXV	ਇੱਕ हज़ार ਨੌਂ ਸੌ ਪੈਂਠ
MCMLXVI	ਇੱਕ हज़ार ਨੌਂ ਸੌ ਛਿਆਠ
MCMLXVII	ਇੱਕ हज़ार ਨੌਂ ਸੌ ਸਤੱਠ
MCMLXVIII	ਇੱਕ हज़ार ਨੌਂ ਸੌ ਅਠੱਠ
MCMLXIX	ਇੱਕ हज़ार ਨੌਂ ਸੌ ਉਨੱਤਰ
MCMLXX	ਇੱਕ हज़ार ਨੌਂ ਸੌ ਸੱਤਰ
MCMLXXI	ਇੱਕ हज़ार ਨੌਂ ਸੌ ਇਕੱਤਰ
MCMLXXII	ਇੱਕ हज़ार ਨੌਂ ਸੌ ਬਹੱਤਰ
MCMLXXIII	ਇੱਕ हज़ार ਨੌਂ ਸੌ ਤਿਹੱਤਰ
MCMLXXIV	ਇੱਕ हज़ार ਨੌਂ ਸੌ ਚੁਹੱਤਰ
MCMLXXV	ਇੱਕ हज़ार ਨੌਂ ਸੌ ਪੰਝੱਤਰ
MCMLXXVI	ਇੱਕ हज़ार ਨੌਂ ਸੌ ਛਿਹੱਤਰ
MCMLXXVII	ਇੱਕ हज़ार ਨੌਂ ਸੌ ਸਤੱਤਰ
MCMLXXVIII	ਇੱਕ हज़ार ਨੌਂ ਸੌ ਅਠੱਤਰ
MCMLXXIX	ਇੱਕ हज़ार ਨੌਂ ਸੌ ਉਨਾਸੀ
MCMLXXX	ਇੱਕ हज़ार ਨੌਂ ਸੌ ਅੱਸੀ
MCMLXXXI	ਇੱਕ हज़ार ਨੌਂ ਸੌ ਇਕਾਸੀ
MCMLXXXII	ਇੱਕ हज़ार ਨੌਂ ਸੌ ਬਿਆਸੀ
MCMLXXXIII	ਇੱਕ हज़ार ਨੌਂ ਸੌ ਤਿਰਾਸੀ
MCMLXXXIV	ਇੱਕ हज़ार ਨੌਂ ਸੌ ਚੁਰਾਸੀ
MCMLXXXV	ਇੱਕ हज़ार ਨੌਂ ਸੌ ਪਚਾਸੀ
MCMLXXXVI	ਇੱਕ हज़ार ਨੌਂ ਸੌ ਛਿਆਸੀ
MCMLXXXVII	ਇੱਕ हज़ार ਨੌਂ ਸੌ ਸਤਾਸੀ
MCMLXXXVIII	ਇੱਕ हज़ार ਨੌਂ ਸੌ ਅਠਾਸੀ
MCMLXXXIX	ਇੱਕ हज़ार ਨੌਂ ਸੌ ਨਵਾਸੀ
MCMXC	ਇੱਕ हज़ार ਨੌਂ ਸੌ ਨੱਬੇ
MCMXCI	ਇੱਕ हज़ार ਨੌਂ ਸੌ ਇਕਾਨਵੇਂ
MCMXCII	ਇੱਕ हज़ार ਨੌਂ ਸੌ ਬਾਨਵੇਂ
MCMXCIII	ਇੱਕ हज़ार ਨੌਂ ਸੌ ਤਰਾਨਵੇਂ
MCMXCIV	ਇੱਕ हज़ार ਨੌਂ ਸੌ ਚੁਰਾਨਵੇਂ
MCMXCV	ਇੱਕ हज़ार ਨੌਂ ਸੌ ਪਚਾਨਵੇਂ
MCMXCVI	ਇੱਕ हज़ार ਨੌਂ ਸੌ ਛਿਆਨਵੇਂ
MCMXCVII	ਇੱਕ हज़ार ਨੌਂ ਸੌ ਸਤਾਨਵੇਂ
MCMXCVIII	ਇੱਕ हज़ार ਨੌਂ ਸੌ ਅਠਾਨਵੇਂ
MCMXCIX	ਇੱਕ हज़ार ਨੌਂ ਸੌ ਨਿਨਾਨਵੇਂ
MM	ਦੋ हज़ार
